MESE,ANNO,REGIONE/STATO,TIPO SOGGETTO,RETTIFICHE,CAMBI DI RESIDENZA,AUTOCERTIFICAZIONI,VISURE,CERTIFICATI,TOTALE
4,2021,ABRUZZO,Residenti,0,0,326,243,0,569
4,2021,AUSTRIA,AIRE,0,0,6,4,0,10
4,2021,BASILICATA,Residenti,0,0,206,126,0,332
4,2021,BELGIO,AIRE,0,0,2,6,0,8
4,2021,BRASILE,AIRE,0,0,10,10,0,20
4,2021,BULGARIA,AIRE,0,0,0,1,0,1
4,2021,CALABRIA,Residenti,0,0,498,322,0,820
4,2021,CAMPANIA,Residenti,0,0,1227,881,0,2108
4,2021,CANADA,AIRE,0,0,1,5,0,6
4,2021,COLOMBIA,AIRE,0,0,0,1,0,1
4,2021,DANIMARCA,AIRE,0,0,1,3,0,4
4,2021,EGITTO,AIRE,0,0,3,36,0,39
4,2021,EMILIA ROMAGNA,Residenti,0,0,985,636,0,1621
4,2021,FINLANDIA,AIRE,0,0,0,1,0,1
4,2021,FRANCIA,AIRE,0,0,9,8,0,17
4,2021,FRIULI VENEZIA GIULIA,Residenti,0,0,397,186,0,583
4,2021,GERMANIA,AIRE,0,0,7,5,0,12
4,2021,IRLANDA,AIRE,0,0,1,0,0,1
4,2021,ISRAELE,AIRE,0,0,2,1,0,3
4,2021,LAZIO,Residenti,1,0,1811,1573,0,3385
4,2021,LETTONIA,AIRE,0,0,1,1,0,2
4,2021,LIGURIA,Residenti,0,0,272,225,0,497
4,2021,LOMBARDIA,Residenti,36,0,1897,1229,0,3162
4,2021,MARCHE,Residenti,0,0,302,210,0,512
4,2021,MAROCCO,AIRE,0,0,11,2,0,13
4,2021,MOLISE,Residenti,0,0,73,37,0,110
4,2021,NEPAL,AIRE,0,0,1,0,0,1
4,2021,NORVEGIA,AIRE,0,0,1,0,0,1
4,2021,NUOVA ZELANDA,AIRE,0,0,1,1,0,2
4,2021,PAESI BASSI,AIRE,0,0,7,4,0,11
4,2021,PERU',AIRE,0,0,1,0,0,1
4,2021,PIEMONTE,Residenti,12,0,692,460,0,1164
4,2021,POLONIA,AIRE,0,0,1,0,0,1
4,2021,PORTOGALLO,AIRE,2,0,22,85,0,109
4,2021,PUGLIA,Residenti,11,0,853,664,0,1528
4,2021,QATAR,AIRE,0,0,2,0,0,2
4,2021,REGNO UNITO,AIRE,0,0,10,16,0,26
4,2021,REPUBBLICA CECA,AIRE,0,0,3,0,0,3
4,2021,ROMANIA,AIRE,0,0,2,0,0,2
4,2021,RUANDA,AIRE,0,0,1,0,0,1
4,2021,SAN MARINO,AIRE,0,0,1,1,0,2
4,2021,SARDEGNA,Residenti,0,0,431,302,0,733
4,2021,SICILIA,Residenti,0,0,2052,1130,0,3182
4,2021,SLOVENIA,AIRE,0,0,1,0,0,1
4,2021,SPAGNA,AIRE,0,0,6,6,0,12
4,2021,STATI UNITI D'AMERICA,AIRE,0,0,3,4,0,7
4,2021,SVEZIA,AIRE,0,0,1,8,0,9
4,2021,SVIZZERA,AIRE,0,0,19,18,0,37
4,2021,THAILANDIA,AIRE,0,0,1,0,0,1
4,2021,TOSCANA,Residenti,23,0,719,594,0,1336
4,2021,TRENTINO ALTO ADIGE,Residenti,0,0,359,192,0,551
4,2021,TUNISIA,AIRE,0,0,2,1,0,3
4,2021,UMBRIA,Residenti,0,0,232,155,0,387
4,2021,UNGHERIA,AIRE,0,0,1,2,0,3
4,2021,URUGUAY,AIRE,0,0,5,0,0,5
4,2021,VALLE D'AOSTA,Residenti,0,0,27,25,0,52
4,2021,VENETO,Residenti,0,0,972,664,0,1636
4,2021,VENEZUELA,AIRE,0,0,4,3,0,7
5,2021,ABRUZZO,Residenti,0,0,263,162,0,425
5,2021,AUSTRALIA,AIRE,0,0,3,0,0,3
5,2021,AUSTRIA,AIRE,0,0,3,0,0,3
5,2021,BASILICATA,Residenti,0,0,115,77,0,192
5,2021,BELGIO,AIRE,0,0,4,3,0,7
5,2021,BOLIVIA,AIRE,0,0,1,2,0,3
5,2021,BRASILE,AIRE,0,0,25,5,0,30
5,2021,CALABRIA,Residenti,0,0,281,212,0,493
5,2021,CAMPANIA,Residenti,0,0,902,595,0,1497
5,2021,CANADA,AIRE,0,0,2,2,0,4
5,2021,CILE,AIRE,0,0,1,0,0,1
5,2021,EGITTO,AIRE,0,0,2,0,0,2
5,2021,EMILIA ROMAGNA,Residenti,0,0,990,563,0,1553
5,2021,EMIRATI ARABI UNITI,AIRE,0,0,1,0,0,1
5,2021,ESTONIA,AIRE,0,0,1,0,0,1
5,2021,FILIPPINE,AIRE,0,0,2,0,0,2
5,2021,FINLANDIA,AIRE,0,0,0,1,0,1
5,2021,FRANCIA,AIRE,2,0,14,21,0,37
5,2021,FRIULI VENEZIA GIULIA,Residenti,0,0,281,136,0,417
5,2021,GERMANIA,AIRE,0,0,8,6,0,14
5,2021,IRLANDA,AIRE,0,0,2,5,0,7
5,2021,LAZIO,Residenti,0,0,1150,947,0,2097
5,2021,LIBIA,AIRE,0,0,0,2,0,2
5,2021,LIGURIA,Residenti,0,0,128,121,0,249
5,2021,LITUANIA,AIRE,0,0,5,0,0,5
5,2021,LOMBARDIA,Residenti,34,0,1920,1301,0,3255
5,2021,LUSSEMBURGO,AIRE,0,0,0,3,0,3
5,2021,MADAGASCAR,AIRE,0,0,13,0,0,13
5,2021,MALTA,AIRE,0,0,3,0,0,3
5,2021,MARCHE,Residenti,0,0,269,134,0,403
5,2021,MAROCCO,AIRE,0,0,1,0,0,1
5,2021,MOLISE,Residenti,0,0,19,11,0,30
5,2021,MONACO,AIRE,0,0,1,0,0,1
5,2021,MYANMAR,AIRE,0,0,4,0,0,4
5,2021,NORVEGIA,AIRE,0,0,2,1,0,3
5,2021,PAESI BASSI,AIRE,0,0,3,6,0,9
5,2021,PANAMA,AIRE,0,0,1,0,0,1
5,2021,PIEMONTE,Residenti,8,0,633,461,0,1102
5,2021,PORTOGALLO,AIRE,0,0,3,0,0,3
5,2021,PUGLIA,Residenti,4,0,460,380,0,844
5,2021,REGNO UNITO,AIRE,0,0,10,21,0,31
5,2021,REPUBBLICA DI COREA,AIRE,0,0,2,0,0,2
5,2021,REPUBBLICA DOMINICANA,AIRE,0,0,1,0,0,1
5,2021,REPUBBLICA POPOLARE CINESE,AIRE,0,0,1,0,0,1
5,2021,ROMANIA,AIRE,0,0,2,2,0,4
5,2021,SARDEGNA,Residenti,0,0,277,210,0,487
5,2021,SICILIA,Residenti,0,0,2409,1329,0,3738
5,2021,SLOVENIA,AIRE,0,0,1,0,0,1
5,2021,SPAGNA,AIRE,0,0,8,7,0,15
5,2021,STATI UNITI D'AMERICA,AIRE,0,0,5,6,0,11
5,2021,SUD AFRICA,AIRE,0,0,0,1,0,1
5,2021,SVIZZERA,AIRE,0,0,7,11,0,18
5,2021,TOSCANA,Residenti,16,0,510,346,0,872
5,2021,TRENTINO ALTO ADIGE,Residenti,0,0,442,211,0,653
5,2021,TUNISIA,AIRE,0,0,1,0,0,1
5,2021,TURCHIA,AIRE,0,0,1,2,0,3
5,2021,UMBRIA,Residenti,0,0,253,142,0,395
5,2021,UNGHERIA,AIRE,0,0,2,0,0,2
5,2021,VALLE D'AOSTA,Residenti,0,0,22,6,0,28
5,2021,VENETO,Residenti,0,0,825,491,0,1316
5,2021,VENEZUELA,AIRE,0,0,0,2,0,2
6,2021,ABRUZZO,Residenti,9,0,174,116,0,299
6,2021,ARGENTINA,AIRE,0,0,0,2,0,2
6,2021,AUSTRALIA,AIRE,0,0,1,0,0,1
6,2021,AUSTRIA,AIRE,2,0,2,1,0,5
6,2021,BASILICATA,Residenti,2,0,119,89,0,210
6,2021,BELGIO,AIRE,2,0,6,4,0,12
6,2021,BRASILE,AIRE,10,0,6,31,0,47
6,2021,BULGARIA,AIRE,0,0,1,2,0,3
6,2021,CALABRIA,Residenti,31,0,337,269,0,637
6,2021,CAMPANIA,Residenti,30,0,838,610,0,1478
6,2021,CILE,AIRE,0,0,1,5,0,6
6,2021,COLOMBIA,AIRE,0,0,3,4,0,7
6,2021,EGITTO,AIRE,1,0,0,0,0,1
6,2021,EMILIA ROMAGNA,Residenti,43,0,1064,610,0,1717
6,2021,EMIRATI ARABI UNITI,AIRE,0,0,3,2,0,5
6,2021,ESTONIA,AIRE,1,0,0,0,0,1
6,2021,FRANCIA,AIRE,0,0,7,18,0,25
6,2021,FRIULI VENEZIA GIULIA,Residenti,4,0,210,136,0,350
6,2021,GERMANIA,AIRE,4,0,12,21,0,37
6,2021,GRECIA,AIRE,0,0,1,0,0,1
6,2021,IRLANDA,AIRE,1,0,4,0,0,5
6,2021,LAZIO,Residenti,43,0,1279,1305,0,2627
6,2021,LIGURIA,Residenti,6,0,134,134,0,274
6,2021,LOMBARDIA,Residenti,114,0,1890,1205,0,3209
6,2021,MALTA,AIRE,0,0,1,2,0,3
6,2021,MARCHE,Residenti,14,0,256,172,0,442
6,2021,MAROCCO,AIRE,0,0,1,1,0,2
6,2021,MOLISE,Residenti,0,0,45,31,0,76
6,2021,NORVEGIA,AIRE,0,0,1,0,0,1
6,2021,PAESI BASSI,AIRE,1,0,5,2,0,8
6,2021,PIEMONTE,Residenti,37,0,613,372,0,1022
6,2021,PORTOGALLO,AIRE,1,0,2,2,0,5
6,2021,PUGLIA,Residenti,30,0,488,383,0,901
6,2021,REGNO UNITO,AIRE,1,0,17,15,0,33
6,2021,REPUBBLICA CECA,AIRE,0,0,1,0,0,1
6,2021,REPUBBLICA DOMINICANA,AIRE,0,0,2,0,0,2
6,2021,REPUBBLICA POPOLARE CINESE,AIRE,0,0,1,0,0,1
6,2021,SARDEGNA,Residenti,17,0,294,284,0,595
6,2021,SICILIA,Residenti,45,0,1847,1075,0,2967
6,2021,SLOVENIA,AIRE,0,0,1,2,0,3
6,2021,SPAGNA,AIRE,2,0,12,20,0,34
6,2021,STATI UNITI D'AMERICA,AIRE,0,0,7,1,0,8
6,2021,SVEZIA,AIRE,0,0,1,0,0,1
6,2021,SVIZZERA,AIRE,3,0,6,9,0,18
6,2021,THAILANDIA,AIRE,0,0,1,3,0,4
6,2021,TOSCANA,Residenti,18,0,471,390,0,879
6,2021,TRENTINO ALTO ADIGE,Residenti,7,0,434,183,0,624
6,2021,TUNISIA,AIRE,0,0,1,0,0,1
6,2021,TURCHIA,AIRE,0,0,2,0,0,2
6,2021,UMBRIA,Residenti,13,0,265,171,0,449
6,2021,VALLE D'AOSTA,Residenti,0,0,19,20,0,39
6,2021,VENETO,Residenti,21,0,882,494,0,1397
7,2021,ABRUZZO,Residenti,26,0,200,179,0,405
7,2021,ARGENTINA,AIRE,0,0,0,4,0,4
7,2021,AUSTRIA,AIRE,0,0,2,1,0,3
7,2021,BASILICATA,Residenti,5,0,96,77,0,178
7,2021,BELGIO,AIRE,1,0,6,11,0,18
7,2021,BRASILE,AIRE,3,0,7,23,0,33
7,2021,BULGARIA,AIRE,2,0,3,3,0,8
7,2021,CALABRIA,Residenti,37,0,256,198,0,491
7,2021,CAMPANIA,Residenti,75,0,685,595,0,1355
7,2021,COLOMBIA,AIRE,0,0,1,0,0,1
7,2021,EGITTO,AIRE,1,0,0,24,0,25
7,2021,EMILIA ROMAGNA,Residenti,47,0,1048,638,0,1733
7,2021,EMIRATI ARABI UNITI,AIRE,0,0,9,0,0,9
7,2021,FINLANDIA,AIRE,0,0,0,1,0,1
7,2021,FRANCIA,AIRE,0,0,3,3,0,6
7,2021,FRIULI VENEZIA GIULIA,Residenti,16,0,249,136,0,401
7,2021,GERMANIA,AIRE,1,0,15,10,0,26
7,2021,GRECIA,AIRE,1,0,0,0,0,1
7,2021,IRLANDA,AIRE,0,0,2,0,0,2
7,2021,LAZIO,Residenti,90,0,1020,822,0,1932
7,2021,LIGURIA,Residenti,13,0,99,94,0,206
7,2021,LOMBARDIA,Residenti,193,0,1603,1039,0,2835
7,2021,MARCHE,Residenti,11,0,256,123,0,390
7,2021,MOLISE,Residenti,1,0,35,17,0,53
7,2021,MONACO,AIRE,0,0,1,1,0,2
7,2021,PAESI BASSI,AIRE,2,0,12,10,0,24
7,2021,PANAMA,AIRE,0,0,5,0,0,5
7,2021,PIEMONTE,Residenti,39,0,568,304,0,911
7,2021,PORTOGALLO,AIRE,4,0,8,3,0,15
7,2021,PUGLIA,Residenti,33,0,400,295,0,728
7,2021,REGNO UNITO,AIRE,4,0,16,26,0,46
7,2021,REPUBBLICA DOMINICANA,AIRE,0,0,1,0,0,1
7,2021,REPUBBLICA POPOLARE CINESE,AIRE,0,0,0,1,0,1
7,2021,ROMANIA,AIRE,0,0,1,0,0,1
7,2021,SAN MARINO,AIRE,1,0,2,3,0,6
7,2021,SARDEGNA,Residenti,17,0,250,200,0,467
7,2021,SICILIA,Residenti,150,0,1600,857,0,2607
7,2021,SLOVENIA,AIRE,1,0,1,0,0,2
7,2021,SPAGNA,AIRE,5,0,16,12,0,33
7,2021,STATI UNITI D'AMERICA,AIRE,1,0,4,1,0,6
7,2021,SVEZIA,AIRE,2,0,12,0,0,14
7,2021,SVIZZERA,AIRE,0,0,3,1,0,4
7,2021,TOSCANA,Residenti,52,0,436,331,0,819
7,2021,TRENTINO ALTO ADIGE,Residenti,20,0,505,239,0,764
7,2021,TUNISIA,AIRE,0,0,0,4,0,4
7,2021,TURCHIA,AIRE,0,0,0,4,0,4
7,2021,UMBRIA,Residenti,16,0,248,139,0,403
7,2021,URUGUAY,AIRE,1,0,1,2,0,4
7,2021,VALLE D'AOSTA,Residenti,0,0,2,5,0,7
7,2021,VENETO,Residenti,38,0,725,485,0,1248
7,2021,VENEZUELA,AIRE,0,0,0,1,0,1
8,2021,ABRUZZO,Residenti,19,0,156,108,0,283
8,2021,ALBANIA,AIRE,0,0,4,0,0,4
8,2021,ARGENTINA,AIRE,1,0,2,1,0,4
8,2021,AUSTRALIA,AIRE,1,0,1,0,0,2
8,2021,AUSTRIA,AIRE,1,0,0,6,0,7
8,2021,BASILICATA,Residenti,8,0,77,53,0,138
8,2021,BELGIO,AIRE,0,0,2,0,0,2
8,2021,BRASILE,AIRE,1,0,8,11,0,20
8,2021,CALABRIA,Residenti,40,0,214,135,0,389
8,2021,CAMPANIA,Residenti,94,0,587,438,0,1119
8,2021,CANADA,AIRE,0,0,1,0,0,1
8,2021,CILE,AIRE,0,0,1,0,0,1
8,2021,EGITTO,AIRE,0,0,0,3,0,3
8,2021,EMILIA ROMAGNA,Residenti,56,0,861,580,0,1497
8,2021,EMIRATI ARABI UNITI,AIRE,0,0,2,1,0,3
8,2021,FRANCIA,AIRE,3,0,10,10,0,23
8,2021,FRIULI VENEZIA GIULIA,Residenti,11,0,185,106,0,302
8,2021,GERMANIA,AIRE,7,0,12,7,0,26
8,2021,GIAPPONE,AIRE,0,0,2,4,0,6
8,2021,IRAN,AIRE,0,0,0,1,0,1
8,2021,IRLANDA,AIRE,1,0,0,0,0,1
8,2021,LAZIO,Residenti,69,0,750,747,0,1566
8,2021,LIGURIA,Residenti,9,0,83,60,0,152
8,2021,LOMBARDIA,Residenti,153,0,1064,656,0,1873
8,2021,LUSSEMBURGO,AIRE,0,0,1,0,0,1
8,2021,MADAGASCAR,AIRE,0,0,1,0,0,1
8,2021,MALTA,AIRE,0,0,1,0,0,1
8,2021,MARCHE,Residenti,5,0,146,102,0,253
8,2021,MAROCCO,AIRE,0,0,5,0,0,5
8,2021,MESSICO,AIRE,0,0,1,0,0,1
8,2021,MOLISE,Residenti,3,0,22,15,0,40
8,2021,NORVEGIA,AIRE,0,0,5,2,0,7
8,2021,PAESI BASSI,AIRE,0,0,4,0,0,4
8,2021,PIEMONTE,Residenti,22,0,391,211,0,624
8,2021,PORTOGALLO,AIRE,0,0,14,3,0,17
8,2021,PUGLIA,Residenti,25,0,305,252,0,582
8,2021,QATAR,AIRE,0,0,2,0,0,2
8,2021,REGNO UNITO,AIRE,2,0,11,19,0,32
8,2021,REPUBBLICA CECA,AIRE,2,0,4,4,0,10
8,2021,ROMANIA,AIRE,2,0,1,0,0,3
8,2021,SARDEGNA,Residenti,26,0,213,190,0,429
8,2021,SICILIA,Residenti,98,0,1060,719,0,1877
8,2021,SINGAPORE,AIRE,0,0,3,2,0,5
8,2021,SPAGNA,AIRE,0,0,16,7,0,23
8,2021,STATI UNITI D'AMERICA,AIRE,0,0,10,3,0,13
8,2021,SVIZZERA,AIRE,2,0,5,9,0,16
8,2021,TOSCANA,Residenti,27,0,331,234,0,592
8,2021,TRENTINO ALTO ADIGE,Residenti,24,0,388,189,0,601
8,2021,TUNISIA,AIRE,0,0,3,3,0,6
8,2021,TURCHIA,AIRE,2,0,0,0,0,2
8,2021,UMBRIA,Residenti,19,0,192,162,0,373
8,2021,URUGUAY,AIRE,1,0,0,2,0,3
8,2021,VALLE D'AOSTA,Residenti,0,0,9,11,0,20
8,2021,VENETO,Residenti,42,0,682,357,0,1081
9,2021,ABRUZZO,Residenti,18,0,307,227,0,552
9,2021,ALBANIA,AIRE,0,0,2,0,0,2
9,2021,ARGENTINA,AIRE,2,0,0,0,0,2
9,2021,AUSTRALIA,AIRE,3,0,2,5,0,10
9,2021,AUSTRIA,AIRE,0,0,0,1,0,1
9,2021,BASILICATA,Residenti,13,0,192,138,0,343
9,2021,BELGIO,AIRE,1,0,3,1,0,5
9,2021,BRASILE,AIRE,3,0,9,17,0,29
9,2021,CALABRIA,Residenti,54,0,328,232,0,614
9,2021,CAMPANIA,Residenti,120,0,776,673,0,1569
9,2021,EMILIA ROMAGNA,Residenti,118,0,1459,854,0,2431
9,2021,EMIRATI ARABI UNITI,AIRE,0,0,1,1,0,2
9,2021,FRANCIA,AIRE,11,0,9,15,0,35
9,2021,FRIULI VENEZIA GIULIA,Residenti,16,0,319,139,0,474
9,2021,GERMANIA,AIRE,1,0,12,11,0,24
9,2021,LAZIO,Residenti,176,0,1352,1340,0,2868
9,2021,LIGURIA,Residenti,11,0,97,94,0,202
9,2021,LOMBARDIA,Residenti,198,0,1926,1336,0,3460
9,2021,MARCHE,Residenti,15,0,288,160,0,463
9,2021,MOLISE,Residenti,1,0,30,22,0,53
9,2021,NUOVA ZELANDA,AIRE,0,0,2,0,0,2
9,2021,PAESI BASSI,AIRE,2,0,6,7,0,15
9,2021,PIEMONTE,Residenti,49,0,789,465,0,1303
9,2021,POLONIA,AIRE,0,0,2,0,0,2
9,2021,PORTOGALLO,AIRE,1,0,7,4,0,12
9,2021,PUGLIA,Residenti,50,0,538,419,0,1007
9,2021,REGNO UNITO,AIRE,4,0,12,7,0,23
9,2021,REPUBBLICA CECA,AIRE,0,0,1,3,0,4
9,2021,SARDEGNA,Residenti,30,0,420,270,0,720
9,2021,SICILIA,Residenti,185,0,2263,1289,0,3737
9,2021,SINGAPORE,AIRE,0,0,2,2,0,4
9,2021,SPAGNA,AIRE,3,0,7,8,0,18
9,2021,STATI UNITI D'AMERICA,AIRE,2,0,7,8,0,17
9,2021,SVEZIA,AIRE,0,0,0,2,0,2
9,2021,SVIZZERA,AIRE,5,0,11,1,0,17
9,2021,THAILANDIA,AIRE,1,0,0,1,0,2
9,2021,TOSCANA,Residenti,41,0,648,394,0,1083
9,2021,TRENTINO ALTO ADIGE,Residenti,15,0,533,233,0,781
9,2021,UMBRIA,Residenti,24,0,386,234,0,644
9,2021,UNGHERIA,AIRE,0,0,1,0,0,1
9,2021,URUGUAY,AIRE,0,0,1,2,0,3
9,2021,VALLE D'AOSTA,Residenti,2,0,9,11,0,22
9,2021,VENETO,Residenti,58,0,950,503,0,1511
10,2021,ABRUZZO,Residenti,40,0,481,352,0,873
10,2021,ALBANIA,AIRE,0,0,1,0,0,1
10,2021,ARABIA SAUDITA,AIRE,0,0,2,1,0,3
10,2021,ARGENTINA,AIRE,2,0,2,11,0,15
10,2021,AUSTRALIA,AIRE,0,0,1,0,0,1
10,2021,AUSTRIA,AIRE,0,0,4,6,0,10
10,2021,BASILICATA,Residenti,25,0,299,217,0,541
10,2021,BELGIO,AIRE,4,0,6,6,0,16
10,2021,BRASILE,AIRE,7,0,20,43,0,70
10,2021,BULGARIA,AIRE,1,0,4,2,0,7
10,2021,CALABRIA,Residenti,127,0,1177,832,0,2136
10,2021,CAMBOGIA,AIRE,0,0,4,0,0,4
10,2021,CAMPANIA,Residenti,338,0,3191,2535,0,6064
10,2021,COLOMBIA,AIRE,0,0,1,3,0,4
10,2021,CUBA,AIRE,0,0,1,0,0,1
10,2021,ECUADOR,AIRE,0,0,0,2,0,2
10,2021,EGITTO,AIRE,0,0,1,0,0,1
10,2021,EMILIA ROMAGNA,Residenti,140,0,2502,1451,0,4093
10,2021,EMIRATI ARABI UNITI,AIRE,2,0,2,0,0,4
10,2021,FEDERAZIONE RUSSA,AIRE,0,0,1,0,0,1
10,2021,FILIPPINE,AIRE,1,0,2,4,0,7
10,2021,FRANCIA,AIRE,12,0,34,23,0,69
10,2021,FRIULI VENEZIA GIULIA,Residenti,19,0,562,318,0,899
10,2021,GERMANIA,AIRE,10,0,27,19,0,56
10,2021,GRECIA,AIRE,1,0,7,4,0,12
10,2021,IRLANDA,AIRE,2,0,2,3,0,7
10,2021,LAZIO,Residenti,348,0,3163,2633,16,6160
10,2021,LIGURIA,Residenti,45,0,409,334,0,788
10,2021,LOMBARDIA,Residenti,374,0,3729,2770,0,6873
10,2021,LUSSEMBURGO,AIRE,0,0,2,2,0,4
10,2021,MALAYSIA,AIRE,0,0,1,0,0,1
10,2021,MALTA,AIRE,0,0,1,2,0,3
10,2021,MARCHE,Residenti,28,0,616,336,0,980
10,2021,MESSICO,AIRE,2,0,2,0,0,4
10,2021,MOLDOVA,AIRE,1,0,2,0,0,3
10,2021,MOLISE,Residenti,6,0,143,77,0,226
10,2021,MOZAMBICO,AIRE,2,0,2,13,0,17
10,2021,NAMIBIA,AIRE,0,0,2,0,0,2
10,2021,NORVEGIA,AIRE,0,0,2,5,0,7
10,2021,PAESI BASSI,AIRE,2,0,7,10,0,19
10,2021,PIEMONTE,Residenti,123,0,1587,1071,0,2781
10,2021,PORTOGALLO,AIRE,2,0,3,5,0,10
10,2021,PUGLIA,Residenti,155,0,1920,1362,16,3453
10,2021,QATAR,AIRE,0,0,0,1,0,1
10,2021,REGNO UNITO,AIRE,15,0,30,25,0,70
10,2021,REPUBBLICA CECA,AIRE,0,0,0,1,0,1
10,2021,REPUBBLICA DOMINICANA,AIRE,0,0,1,0,0,1
10,2021,REPUBBLICA POPOLARE CINESE,AIRE,0,0,1,0,0,1
10,2021,ROMANIA,AIRE,1,0,1,0,0,2
10,2021,SARDEGNA,Residenti,70,0,886,605,0,1561
10,2021,SERBIA,AIRE,1,0,1,0,0,2
10,2021,SICILIA,Residenti,333,0,3982,2630,0,6945
10,2021,SINGAPORE,AIRE,0,0,1,0,0,1
10,2021,SLOVENIA,AIRE,1,0,1,0,0,2
10,2021,SPAGNA,AIRE,5,0,25,26,0,56
10,2021,STATI UNITI D'AMERICA,AIRE,11,0,8,4,0,23
10,2021,SVEZIA,AIRE,0,0,2,1,0,3
10,2021,SVIZZERA,AIRE,8,0,19,12,0,39
10,2021,THAILANDIA,AIRE,3,0,1,2,0,6
10,2021,TOSCANA,Residenti,98,0,1223,855,0,2176
10,2021,TRENTINO ALTO ADIGE,Residenti,29,0,740,337,0,1106
10,2021,TUNISIA,AIRE,3,0,25,10,0,38
10,2021,UCRAINA,AIRE,0,0,0,2,0,2
10,2021,UMBRIA,Residenti,31,0,489,268,0,788
10,2021,VALLE D'AOSTA,Residenti,2,0,40,30,0,72
10,2021,VENETO,Residenti,132,0,1786,1143,0,3061
10,2021,VENEZUELA,AIRE,0,0,2,1,0,3
11,2021,ABRUZZO,Residenti,606,0,4098,4906,4592,14202
11,2021,ALBANIA,AIRE,6,0,6,8,15,35
11,2021,ALGERIA,AIRE,0,0,1,4,11,16
11,2021,ANGOLA,AIRE,0,0,0,3,0,3
11,2021,ARABIA SAUDITA,AIRE,4,0,6,5,10,25
11,2021,ARGENTINA,AIRE,11,0,25,17,36,89
11,2021,AUSTRALIA,AIRE,17,0,47,53,31,148
11,2021,AUSTRIA,AIRE,11,0,35,40,43,129
11,2021,BAHAMAS,AIRE,1,0,0,0,0,1
11,2021,BAHREIN,AIRE,0,0,1,6,5,12
11,2021,BANGLADESH,AIRE,1,0,1,0,0,2
11,2021,BASILICATA,Residenti,230,0,1992,2480,2154,6856
11,2021,BELGIO,AIRE,61,0,63,100,163,387
11,2021,BOSNIA-ERZEGOVINA,AIRE,0,0,0,2,0,2
11,2021,BRASILE,AIRE,41,0,138,168,109,456
11,2021,BULGARIA,AIRE,7,0,20,17,21,65
11,2021,CALABRIA,Residenti,1036,0,6819,7995,7627,23477
11,2021,CAMBOGIA,AIRE,0,0,3,1,0,4
11,2021,CAMERUN,AIRE,3,0,3,5,2,13
11,2021,CAMPANIA,Residenti,3284,0,19823,25204,24291,72602
11,2021,CANADA,AIRE,12,0,6,21,22,61
11,2021,CAPO VERDE,AIRE,0,0,0,2,4,6
11,2021,CILE,AIRE,3,0,9,3,11,26
11,2021,CIPRO,AIRE,7,0,4,5,7,23
11,2021,COLOMBIA,AIRE,8,0,8,14,10,40
11,2021,COSTA RICA,AIRE,0,0,0,2,3,5
11,2021,CROAZIA,AIRE,3,0,3,4,3,13
11,2021,DANIMARCA,AIRE,7,0,19,28,12,66
11,2021,ECUADOR,AIRE,1,0,9,5,12,27
11,2021,EGITTO,AIRE,4,0,4,11,7,26
11,2021,EMILIA ROMAGNA,Residenti,1563,0,14930,18428,17090,52011
11,2021,EMIRATI ARABI UNITI,AIRE,7,0,40,25,47,119
11,2021,ESTONIA,AIRE,1,0,2,7,6,16
11,2021,ETIOPIA,AIRE,0,0,0,1,12,13
11,2021,FEDERAZIONE RUSSA,AIRE,12,0,10,18,24,64
11,2021,FILIPPINE,AIRE,9,0,5,19,7,40
11,2021,FINLANDIA,AIRE,4,0,2,3,9,18
11,2021,FRANCIA,AIRE,115,0,251,278,257,901
11,2021,FRIULI VENEZIA GIULIA,Residenti,375,0,4409,5012,4325,14121
11,2021,GEORGIA,AIRE,0,0,0,1,0,1
11,2021,GERMANIA,AIRE,141,0,234,391,298,1064
11,2021,GHANA,AIRE,0,0,0,1,0,1
11,2021,GIAPPONE,AIRE,7,0,2,7,7,23
11,2021,GIORDANIA,AIRE,1,0,0,4,9,14
11,2021,GRECIA,AIRE,10,0,6,18,17,51
11,2021,GUATEMALA,AIRE,0,0,1,0,1,2
11,2021,HONDURAS,AIRE,0,0,1,1,0,2
11,2021,IGNOTO,AIRE,2,0,5,2,1,10
11,2021,INDIA,AIRE,1,0,2,0,2,5
11,2021,INDONESIA,AIRE,4,0,2,0,1,7
11,2021,IRAN,AIRE,0,0,0,1,0,1
11,2021,IRAQ,AIRE,1,0,0,3,1,5
11,2021,IRLANDA,AIRE,29,0,26,47,25,127
11,2021,ISLANDA,AIRE,0,0,0,3,0,3
11,2021,ISRAELE,AIRE,5,0,5,2,14,26
11,2021,KAZAKHSTAN,AIRE,1,0,2,6,1,10
11,2021,KENYA,AIRE,2,0,5,4,6,17
11,2021,KUWAIT,AIRE,1,0,1,1,0,3
11,2021,LAZIO,Residenti,4084,0,20404,28703,27258,80449
11,2021,LETTONIA,AIRE,1,0,5,0,0,6
11,2021,LIBANO,AIRE,0,0,1,1,3,5
11,2021,LIBIA,AIRE,1,0,0,0,0,1
11,2021,LIECHTENSTEIN,AIRE,1,0,0,0,0,1
11,2021,LIGURIA,Residenti,559,0,4728,5932,5530,16749
11,2021,LITUANIA,AIRE,0,0,0,2,0,2
11,2021,LOMBARDIA,Residenti,4108,0,32902,38380,40438,115828
11,2021,LUSSEMBURGO,AIRE,25,0,24,33,28,110
11,2021,MACEDONIA DEL NORD,AIRE,0,0,0,0,2,2
11,2021,MALAYSIA,AIRE,6,0,7,8,9,30
11,2021,MALDIVE,AIRE,1,0,0,0,1,2
11,2021,MALI,AIRE,1,0,0,0,1,2
11,2021,MALTA,AIRE,13,0,6,32,26,77
11,2021,MARCHE,Residenti,406,0,4268,4644,5168,14486
11,2021,MAROCCO,AIRE,3,0,1,3,6,13
11,2021,MARTINICA,AIRE,0,0,0,0,2,2
11,2021,MESSICO,AIRE,5,0,13,23,9,50
11,2021,MOLDOVA,AIRE,1,0,4,4,1,10
11,2021,MOLISE,Residenti,165,0,1093,1427,1376,4061
11,2021,MONACO,AIRE,1,0,4,5,7,17
11,2021,MONTENEGRO,AIRE,0,0,0,3,1,4
11,2021,MOZAMBICO,AIRE,1,0,3,2,0,6
11,2021,MYANMAR,AIRE,0,0,0,1,2,3
11,2021,NICARAGUA,AIRE,0,0,0,1,0,1
11,2021,NIGERIA,AIRE,1,0,5,7,4,17
11,2021,NORVEGIA,AIRE,6,0,4,11,6,27
11,2021,NUOVA ZELANDA,AIRE,4,0,2,8,2,16
11,2021,PAESI BASSI,AIRE,41,0,69,83,60,253
11,2021,PAKISTAN,AIRE,3,0,0,2,0,5
11,2021,PANAMA,AIRE,0,0,1,3,13,17
11,2021,PARAGUAY,AIRE,0,0,2,0,4,6
11,2021,PERU',AIRE,2,0,2,1,1,6
11,2021,PIEMONTE,Residenti,1572,0,13107,15947,14437,45063
11,2021,POLONIA,AIRE,12,0,28,31,20,91
11,2021,PORTOGALLO,AIRE,35,0,116,140,113,404
11,2021,PUGLIA,Residenti,1789,0,13637,16133,15783,47342
11,2021,QATAR,AIRE,4,0,8,4,10,26
11,2021,REGNO UNITO,AIRE,200,0,329,567,329,1425
11,2021,REPUBBLICA CECA,AIRE,10,0,15,51,21,97
11,2021,REPUBBLICA DEMOCRATICA DEL CONGO,AIRE,0,0,0,4,0,4
11,2021,REPUBBLICA DI COREA,AIRE,3,0,4,0,6,13
11,2021,REPUBBLICA DOMINICANA,AIRE,3,0,6,2,13,24
11,2021,REPUBBLICA POPOLARE CINESE,AIRE,18,0,31,37,25,111
11,2021,ROMANIA,AIRE,9,0,25,40,38,112
11,2021,SAN MARINO,AIRE,4,0,12,21,25,62
11,2021,SARDEGNA,Residenti,646,0,5292,6630,5992,18560
11,2021,SENEGAL,AIRE,2,0,4,1,3,10
11,2021,SERBIA,AIRE,0,0,5,3,0,8
11,2021,SEYCHELLES,AIRE,0,0,1,2,1,4
11,2021,SICILIA,Residenti,2471,0,16671,19207,18272,56621
11,2021,SINGAPORE,AIRE,2,0,6,7,4,19
11,2021,SLOVACCHIA,AIRE,8,0,11,5,5,29
11,2021,SLOVENIA,AIRE,3,0,17,26,13,59
11,2021,SPAGNA,AIRE,77,0,149,165,174,565
11,2021,SRI LANKA,AIRE,0,0,0,2,0,2
11,2021,STATI UNITI D'AMERICA,AIRE,75,0,114,228,163,580
11,2021,SUDAN,AIRE,0,0,0,1,0,1
11,2021,SVEZIA,AIRE,10,0,15,19,17,61
11,2021,SVIZZERA,AIRE,115,0,249,291,239,894
11,2021,TAIWAN,AIRE,1,0,1,1,5,8
11,2021,TANZANIA,AIRE,1,0,2,0,1,4
11,2021,THAILANDIA,AIRE,18,0,22,61,13,114
11,2021,TIMOR ORIENTALE,AIRE,1,0,0,6,0,7
11,2021,TOSCANA,Residenti,1294,0,11335,14459,12480,39568
11,2021,TRENTINO ALTO ADIGE,Residenti,265,0,3433,3635,3147,10480
11,2021,TUNISIA,AIRE,28,0,45,48,45,166
11,2021,TURCHIA,AIRE,4,0,12,9,11,36
11,2021,UCRAINA,AIRE,6,0,12,14,23,55
11,2021,UGANDA,AIRE,1,0,1,0,1,3
11,2021,UMBRIA,Residenti,326,0,2645,3155,3111,9237
11,2021,UNGHERIA,AIRE,2,0,3,10,5,20
11,2021,URUGUAY,AIRE,3,0,2,3,0,8
11,2021,VALLE D'AOSTA,Residenti,53,0,418,477,368,1316
11,2021,VENETO,Residenti,1406,0,17042,19153,17804,55405
11,2021,VENEZUELA,AIRE,8,0,9,1,5,23
11,2021,VIETNAM,AIRE,1,0,2,1,2,6
11,2021,YEMEN,AIRE,0,0,1,0,0,1
12,2021,ABRUZZO,Residenti,167,0,967,1156,2670,4960
12,2021,ALBANIA,AIRE,0,0,1,2,1,4
12,2021,ALGERIA,AIRE,0,0,1,0,2,3
12,2021,ARABIA SAUDITA,AIRE,0,0,1,5,6,12
12,2021,ARGENTINA,AIRE,6,0,9,17,4,36
12,2021,AUSTRALIA,AIRE,4,0,5,8,9,26
12,2021,AUSTRIA,AIRE,5,0,9,19,36,69
12,2021,BAHREIN,AIRE,0,0,1,0,0,1
12,2021,BASILICATA,Residenti,64,0,370,564,1106,2104
12,2021,BELGIO,AIRE,19,0,21,32,28,100
12,2021,BELIZE,AIRE,0,0,1,0,0,1
12,2021,BRASILE,AIRE,28,0,70,98,71,267
12,2021,BULGARIA,AIRE,1,0,1,7,15,24
12,2021,CALABRIA,Residenti,333,0,1443,2069,4021,7866
12,2021,CAMERUN,AIRE,0,0,1,0,0,1
12,2021,CAMPANIA,Residenti,1026,0,4182,6495,13745,25448
12,2021,CANADA,AIRE,2,0,3,4,6,15
12,2021,CILE,AIRE,0,0,1,2,9,12
12,2021,CIPRO,AIRE,1,0,1,1,1,4
12,2021,COLOMBIA,AIRE,2,0,1,3,1,7
12,2021,COSTA D'AVORIO,AIRE,0,0,3,0,0,3
12,2021,COSTA RICA,AIRE,0,0,0,0,4,4
12,2021,CROAZIA,AIRE,0,0,0,0,3,3
12,2021,CUBA,AIRE,0,0,1,2,1,4
12,2021,DANIMARCA,AIRE,4,0,3,6,14,27
12,2021,ECUADOR,AIRE,0,0,0,0,5,5
12,2021,EGITTO,AIRE,2,0,3,4,11,20
12,2021,EMILIA ROMAGNA,Residenti,583,0,4388,5106,12812,22889
12,2021,EMIRATI ARABI UNITI,AIRE,3,0,10,15,14,42
12,2021,FEDERAZIONE RUSSA,AIRE,0,0,2,8,9,19
12,2021,FILIPPINE,AIRE,3,0,1,0,0,4
12,2021,FINLANDIA,AIRE,1,0,0,5,10,16
12,2021,FRANCIA,AIRE,57,0,81,128,185,451
12,2021,FRIULI VENEZIA GIULIA,Residenti,111,0,1131,1337,2826,5405
12,2021,GERMANIA,AIRE,43,0,95,156,140,434
12,2021,GIAPPONE,AIRE,4,0,3,1,3,11
12,2021,GIORDANIA,AIRE,0,0,0,1,1,2
12,2021,GRECIA,AIRE,4,0,1,0,1,6
12,2021,INDIA,AIRE,0,0,0,0,1,1
12,2021,INDONESIA,AIRE,2,0,1,0,3,6
12,2021,IRLANDA,AIRE,7,0,9,15,20,51
12,2021,ISRAELE,AIRE,1,0,2,4,1,8
12,2021,KAZAKHSTAN,AIRE,0,0,0,0,2,2
12,2021,KUWAIT,AIRE,0,0,3,4,7,14
12,2021,LAZIO,Residenti,1131,0,4343,6837,13818,26129
12,2021,LETTONIA,AIRE,2,0,2,1,0,5
12,2021,LIECHTENSTEIN,AIRE,3,0,0,0,0,3
12,2021,LIGURIA,Residenti,222,0,1215,1664,3536,6637
12,2021,LITUANIA,AIRE,1,0,0,0,0,1
12,2021,LOMBARDIA,Residenti,1321,0,9133,10773,29653,50880
12,2021,LUSSEMBURGO,AIRE,5,0,9,12,25,51
12,2021,MALAYSIA,AIRE,3,0,0,1,6,10
12,2021,MALTA,AIRE,3,0,10,18,4,35
12,2021,MARCHE,Residenti,134,0,1108,1327,3590,6159
12,2021,MAROCCO,AIRE,0,0,1,2,6,9
12,2021,MAURITIUS,AIRE,0,0,1,0,0,1
12,2021,MESSICO,AIRE,4,0,7,5,12,28
12,2021,MOLDOVA,AIRE,0,0,0,12,0,12
12,2021,MOLISE,Residenti,29,0,151,228,524,932
12,2021,MONACO,AIRE,1,0,2,2,1,6
12,2021,MOZAMBICO,AIRE,1,0,0,0,0,1
12,2021,NIGER,AIRE,0,0,0,1,0,1
12,2021,NORVEGIA,AIRE,5,0,1,9,11,26
12,2021,NUOVA CALEDONIA,AIRE,0,0,0,0,1,1
12,2021,NUOVA ZELANDA,AIRE,0,0,0,1,2,3
12,2021,OMAN,AIRE,0,0,0,0,1,1
12,2021,PAESI BASSI,AIRE,15,0,35,54,32,136
12,2021,PANAMA,AIRE,0,0,1,0,1,2
12,2021,PARAGUAY,AIRE,0,0,0,2,1,3
12,2021,PERU',AIRE,0,0,0,0,2,2
12,2021,PIEMONTE,Residenti,469,0,2910,3813,9418,16610
12,2021,POLONIA,AIRE,1,0,10,5,10,26
12,2021,PORTOGALLO,AIRE,8,0,29,45,33,115
12,2021,PUGLIA,Residenti,464,0,2512,3434,8621,15031
12,2021,QATAR,AIRE,5,0,1,5,10,21
12,2021,REGNO UNITO,AIRE,75,0,122,219,214,630
12,2021,REPUBBLICA CECA,AIRE,5,0,8,15,18,46
12,2021,REPUBBLICA DI COREA,AIRE,0,0,2,2,0,4
12,2021,REPUBBLICA DOMINICANA,AIRE,1,0,0,5,2,8
12,2021,REPUBBLICA POPOLARE CINESE,AIRE,4,0,11,12,31,58
12,2021,ROMANIA,AIRE,0,0,4,3,13,20
12,2021,SAN MARINO,AIRE,1,0,1,3,7,12
12,2021,SARDEGNA,Residenti,202,0,1150,1611,3348,6311
12,2021,SENEGAL,AIRE,0,0,1,1,6,8
12,2021,SERBIA,AIRE,0,0,1,1,0,2
12,2021,SICILIA,Residenti,755,0,3352,4993,10407,19507
12,2021,SINGAPORE,AIRE,0,0,1,4,13,18
12,2021,SLOVACCHIA,AIRE,0,0,2,3,0,5
12,2021,SLOVENIA,AIRE,4,0,3,0,0,7
12,2021,SPAGNA,AIRE,38,0,70,98,141,347
12,2021,STATI UNITI D'AMERICA,AIRE,34,0,38,59,59,190
12,2021,SUD AFRICA,AIRE,0,0,0,2,0,2
12,2021,SVEZIA,AIRE,0,0,4,6,8,18
12,2021,SVIZZERA,AIRE,23,0,74,77,143,317
12,2021,TANZANIA,AIRE,0,0,2,0,0,2
12,2021,THAILANDIA,AIRE,0,0,9,8,7,24
12,2021,TOSCANA,Residenti,421,0,2543,3683,7999,14646
12,2021,TRENTINO ALTO ADIGE,Residenti,138,0,988,1090,1945,4161
12,2021,TUNISIA,AIRE,13,0,12,37,37,99
12,2021,TURCHIA,AIRE,0,0,0,2,4,6
12,2021,UCRAINA,AIRE,0,0,4,0,1,5
12,2021,UGANDA,AIRE,0,0,0,3,0,3
12,2021,UMBRIA,Residenti,135,0,675,947,2037,3794
12,2021,UNGHERIA,AIRE,0,0,3,3,6,12
12,2021,URUGUAY,AIRE,0,0,1,4,1,6
12,2021,VALLE D'AOSTA,Residenti,13,0,84,118,198,413
12,2021,VENETO,Residenti,530,0,4431,4935,13121,23017
12,2021,VENEZUELA,AIRE,2,0,6,5,7,20
12,2021,VIETNAM,AIRE,0,0,4,4,1,9
1,2022,ABRUZZO,Residenti,224,0,1153,1506,2897,5780
1,2022,ALBANIA,AIRE,1,0,3,1,2,7
1,2022,ANGOLA,AIRE,0,0,1,0,0,1
1,2022,ARABIA SAUDITA,AIRE,1,0,6,3,6,16
1,2022,ARGENTINA,AIRE,1,0,8,5,9,23
1,2022,AUSTRALIA,AIRE,4,0,6,18,8,36
1,2022,AUSTRIA,AIRE,6,0,23,19,25,73
1,2022,BAHREIN,AIRE,0,0,0,2,0,2
1,2022,BANGLADESH,AIRE,0,0,0,0,1,1
1,2022,BASILICATA,Residenti,106,0,549,700,1518,2873
1,2022,BELGIO,AIRE,15,0,19,44,31,109
1,2022,BOLIVIA,AIRE,1,0,0,0,2,3
1,2022,BRASILE,AIRE,18,0,38,69,37,162
1,2022,BULGARIA,AIRE,3,0,4,18,19,44
1,2022,CALABRIA,Residenti,475,0,1952,2654,5370,10451
1,2022,CAMERUN,AIRE,0,0,2,4,2,8
1,2022,CAMPANIA,Residenti,1429,0,6168,8624,20474,36695
1,2022,CANADA,AIRE,1,0,3,3,7,14
1,2022,CILE,AIRE,2,0,0,5,3,10
1,2022,CIPRO,AIRE,1,0,1,8,1,11
1,2022,COLOMBIA,AIRE,4,0,1,0,2,7
1,2022,CONGO,AIRE,0,0,1,1,0,2
1,2022,CROAZIA,AIRE,0,0,1,1,0,2
1,2022,CUBA,AIRE,0,0,0,0,1,1
1,2022,DANIMARCA,AIRE,0,0,2,3,1,6
1,2022,ECUADOR,AIRE,2,0,4,0,10,16
1,2022,EGITTO,AIRE,0,0,5,3,1,9
1,2022,EMILIA ROMAGNA,Residenti,756,0,6177,6541,16216,29690
1,2022,EMIRATI ARABI UNITI,AIRE,5,0,3,2,10,20
1,2022,ESTONIA,AIRE,0,0,0,1,1,2
1,2022,ETIOPIA,AIRE,0,0,1,0,0,1
1,2022,FEDERAZIONE RUSSA,AIRE,3,0,1,8,6,18
1,2022,FILIPPINE,AIRE,7,0,5,0,0,12
1,2022,FINLANDIA,AIRE,1,0,5,3,0,9
1,2022,FRANCIA,AIRE,57,0,83,121,161,422
1,2022,FRIULI VENEZIA GIULIA,Residenti,143,0,1598,1731,3605,7077
1,2022,GERMANIA,AIRE,60,0,75,139,150,424
1,2022,GIAPPONE,AIRE,6,0,3,13,3,25
1,2022,GIORDANIA,AIRE,0,0,1,4,1,6
1,2022,GRECIA,AIRE,2,0,4,4,7,17
1,2022,GUATEMALA,AIRE,1,0,0,0,0,1
1,2022,GUINEA,AIRE,0,0,0,0,2,2
1,2022,HONDURAS,AIRE,0,0,0,0,7,7
1,2022,IGNOTO,AIRE,0,0,1,0,0,1
1,2022,INDONESIA,AIRE,0,0,1,0,3,4
1,2022,IRLANDA,AIRE,7,0,9,22,20,58
1,2022,ISLANDA,AIRE,0,0,1,6,0,7
1,2022,ISRAELE,AIRE,1,0,2,0,0,3
1,2022,KUWAIT,AIRE,0,0,0,4,0,4
1,2022,LAZIO,Residenti,1618,1,5961,8887,18052,34519
1,2022,LETTONIA,AIRE,0,0,0,2,0,2
1,2022,LIGURIA,Residenti,250,0,1286,1674,3749,6959
1,2022,LITUANIA,AIRE,0,0,2,2,1,5
1,2022,LOMBARDIA,Residenti,1905,0,12500,13826,37404,65635
1,2022,LUSSEMBURGO,AIRE,12,0,17,16,13,58
1,2022,MALAYSIA,AIRE,1,0,0,1,1,3
1,2022,MALDIVE,AIRE,0,0,1,0,0,1
1,2022,MALTA,AIRE,3,0,8,10,7,28
1,2022,MARCHE,Residenti,192,0,1444,1733,3873,7242
1,2022,MAROCCO,AIRE,0,0,1,2,3,6
1,2022,MESSICO,AIRE,2,0,4,7,5,18
1,2022,MOLISE,Residenti,50,0,284,310,676,1320
1,2022,MONACO,AIRE,1,0,3,4,7,15
1,2022,MOZAMBICO,AIRE,1,0,1,9,8,19
1,2022,NIGERIA,AIRE,2,0,3,0,0,5
1,2022,NORVEGIA,AIRE,0,0,3,0,3,6
1,2022,NUOVA ZELANDA,AIRE,0,0,1,0,0,1
1,2022,PAESI BASSI,AIRE,6,0,17,34,16,73
1,2022,PANAMA,AIRE,0,0,1,0,2,3
1,2022,PERU',AIRE,5,0,1,5,6,17
1,2022,PIEMONTE,Residenti,648,0,3982,4815,10932,20377
1,2022,POLONIA,AIRE,3,0,8,19,6,36
1,2022,PORTOGALLO,AIRE,10,0,16,33,35,94
1,2022,PUGLIA,Residenti,621,0,3421,4621,12197,20860
1,2022,QATAR,AIRE,2,0,11,13,6,32
1,2022,REGNO UNITO,AIRE,79,0,112,218,143,552
1,2022,REPUBBLICA CECA,AIRE,1,0,6,10,11,28
1,2022,REPUBBLICA DI COREA,AIRE,0,0,1,0,0,1
1,2022,REPUBBLICA DOMINICANA,AIRE,0,0,0,0,2,2
1,2022,REPUBBLICA POPOLARE CINESE,AIRE,1,0,9,9,13,32
1,2022,ROMANIA,AIRE,5,0,7,8,9,29
1,2022,RUANDA,AIRE,0,0,0,1,0,1
1,2022,SAN MARINO,AIRE,1,0,11,2,3,17
1,2022,SARDEGNA,Residenti,243,0,1662,1902,4021,7828
1,2022,SICILIA,Residenti,1085,0,4464,6365,12992,24906
1,2022,SINGAPORE,AIRE,3,0,4,13,9,29
1,2022,SLOVACCHIA,AIRE,3,0,5,3,9,20
1,2022,SLOVENIA,AIRE,0,0,2,2,4,8
1,2022,SPAGNA,AIRE,40,0,107,136,129,412
1,2022,SRI LANKA,AIRE,0,0,0,0,2,2
1,2022,STATI UNITI D'AMERICA,AIRE,38,0,39,89,105,271
1,2022,SVEZIA,AIRE,4,0,7,14,9,34
1,2022,SVIZZERA,AIRE,42,0,65,168,111,386
1,2022,TAIWAN,AIRE,0,0,0,0,4,4
1,2022,THAILANDIA,AIRE,2,0,4,0,3,9
1,2022,TOSCANA,Residenti,521,0,3489,4391,9250,17651
1,2022,TRENTINO ALTO ADIGE,Residenti,113,0,1290,1229,2259,4891
1,2022,TUNISIA,AIRE,10,0,8,27,26,71
1,2022,TURCHIA,AIRE,2,0,1,7,2,12
1,2022,UCRAINA,AIRE,1,0,3,10,8,22
1,2022,UMBRIA,Residenti,164,0,952,1205,2790,5111
1,2022,UNGHERIA,AIRE,1,0,0,8,5,14
1,2022,UZBEKISTAN,AIRE,4,0,2,0,0,6
1,2022,VALLE D'AOSTA,Residenti,16,0,84,136,279,515
1,2022,VENETO,Residenti,646,0,6898,6685,15627,29856
1,2022,VENEZUELA,AIRE,1,0,3,40,1,45
1,2022,VIETNAM,AIRE,0,0,0,5,0,5
2,2022,ABRUZZO,Residenti,117,299,818,1162,2588,4984
2,2022,ALBANIA,AIRE,3,1,4,5,6,19
2,2022,ALGERIA,AIRE,1,1,2,1,2,7
2,2022,ARABIA SAUDITA,AIRE,4,1,5,0,2,12
2,2022,ARGENTINA,AIRE,4,3,4,11,4,26
2,2022,AUSTRALIA,AIRE,6,7,7,9,33,62
2,2022,AUSTRIA,AIRE,1,2,9,18,17,47
2,2022,BAHAMAS,AIRE,0,0,1,0,0,1
2,2022,BAHREIN,AIRE,0,0,1,0,5,6
2,2022,BANGLADESH,AIRE,0,0,0,1,4,5
2,2022,BASILICATA,Residenti,104,240,433,541,1155,2473
2,2022,BELGIO,AIRE,18,8,17,30,31,104
2,2022,BOLIVIA,AIRE,3,0,0,3,0,6
2,2022,BRASILE,AIRE,25,22,34,94,56,231
2,2022,BULGARIA,AIRE,0,1,9,5,5,20
2,2022,CALABRIA,Residenti,306,613,1440,2059,4238,8656
2,2022,CAMERUN,AIRE,0,0,1,1,2,4
2,2022,CAMPANIA,Residenti,1127,1949,4194,6923,17030,31223
2,2022,CANADA,AIRE,1,0,3,1,15,20
2,2022,CAPO VERDE,AIRE,1,0,0,0,2,3
2,2022,CILE,AIRE,1,1,4,1,3,10
2,2022,CIPRO,AIRE,3,0,3,1,6,13
2,2022,COLOMBIA,AIRE,4,0,2,3,2,11
2,2022,CONGO,AIRE,0,0,0,0,1,1
2,2022,CROAZIA,AIRE,0,0,0,0,3,3
2,2022,CUBA,AIRE,1,0,2,3,2,8
2,2022,DANIMARCA,AIRE,2,3,9,0,8,22
2,2022,ECUADOR,AIRE,0,0,1,1,2,4
2,2022,EGITTO,AIRE,0,1,3,1,2,7
2,2022,EMILIA ROMAGNA,Residenti,579,1696,5176,5836,15137,28424
2,2022,EMIRATI ARABI UNITI,AIRE,4,2,17,20,18,61
2,2022,ESTONIA,AIRE,0,0,2,0,0,2
2,2022,FEDERAZIONE RUSSA,AIRE,0,1,5,0,2,8
2,2022,FILIPPINE,AIRE,0,1,3,5,4,13
2,2022,FINLANDIA,AIRE,4,0,0,0,0,4
2,2022,FRANCIA,AIRE,35,29,88,99,197,448
2,2022,FRIULI VENEZIA GIULIA,Residenti,114,244,1270,1261,3129,6018
2,2022,GERMANIA,AIRE,49,94,76,112,111,442
2,2022,GERUSALEMME,AIRE,0,0,0,2,0,2
2,2022,GHANA,AIRE,0,1,1,0,1,3
2,2022,GIAPPONE,AIRE,1,0,0,11,9,21
2,2022,GIORDANIA,AIRE,0,1,0,0,0,1
2,2022,GRECIA,AIRE,2,1,1,0,10,14
2,2022,GUATEMALA,AIRE,0,0,3,21,0,24
2,2022,GUINEA,AIRE,0,0,0,3,0,3
2,2022,IGNOTO,AIRE,0,2,1,0,7,10
2,2022,INDONESIA,AIRE,1,0,0,3,2,6
2,2022,IRAQ,AIRE,0,0,0,1,0,1
2,2022,IRLANDA,AIRE,9,7,15,18,12,61
2,2022,ISRAELE,AIRE,0,0,0,0,1,1
2,2022,KAZAKHSTAN,AIRE,1,0,0,2,1,4
2,2022,KENYA,AIRE,1,0,0,4,3,8
2,2022,KUWAIT,AIRE,0,1,0,0,0,1
2,2022,LAZIO,Residenti,1384,3424,4958,8024,16613,34403
2,2022,LETTONIA,AIRE,1,0,0,0,0,1
2,2022,LIECHTENSTEIN,AIRE,0,0,0,0,1,1
2,2022,LIGURIA,Residenti,178,436,1160,1491,3652,6917
2,2022,LITUANIA,AIRE,0,1,1,0,1,3
2,2022,LOMBARDIA,Residenti,1583,3175,11035,11987,36642,64422
2,2022,LUSSEMBURGO,AIRE,3,4,13,9,26,55
2,2022,MACEDONIA DEL NORD,AIRE,0,0,3,0,0,3
2,2022,MALAYSIA,AIRE,1,0,4,5,9,19
2,2022,MALTA,AIRE,0,0,3,4,9,16
2,2022,MARCHE,Residenti,142,465,1214,1364,3685,6870
2,2022,MAROCCO,AIRE,0,3,1,1,3,8
2,2022,MESSICO,AIRE,2,1,2,8,12,25
2,2022,MOLDOVA,AIRE,1,0,0,0,0,1
2,2022,MOLISE,Residenti,48,58,202,265,497,1070
2,2022,MONACO,AIRE,0,0,2,6,9,17
2,2022,MONTENEGRO,AIRE,1,0,0,0,0,1
2,2022,NORVEGIA,AIRE,2,4,0,9,3,18
2,2022,NUOVA ZELANDA,AIRE,0,0,4,2,1,7
2,2022,PAESI BASSI,AIRE,8,8,14,20,21,71
2,2022,PANAMA,AIRE,0,0,4,0,0,4
2,2022,PARAGUAY,AIRE,0,1,0,1,0,2
2,2022,PERU',AIRE,1,0,1,1,1,4
2,2022,PIEMONTE,Residenti,568,1295,3682,4265,10826,20636
2,2022,POLONIA,AIRE,4,2,8,3,3,20
2,2022,PORTOGALLO,AIRE,8,3,11,29,45,96
2,2022,PUGLIA,Residenti,513,1343,2745,3840,10175,18616
2,2022,QATAR,AIRE,1,1,7,4,8,21
2,2022,REGNO UNITO,AIRE,66,60,93,166,176,561
2,2022,REPUBBLICA CECA,AIRE,3,3,6,11,8,31
2,2022,REPUBBLICA CENTRAFRICANA,AIRE,1,1,0,0,0,2
2,2022,REPUBBLICA DI COREA,AIRE,0,0,1,3,2,6
2,2022,REPUBBLICA DOMINICANA,AIRE,0,0,4,5,2,11
2,2022,REPUBBLICA POPOLARE CINESE,AIRE,3,2,3,7,21,36
2,2022,ROMANIA,AIRE,0,1,10,2,6,19
2,2022,SAN MARINO,AIRE,0,1,2,0,2,5
2,2022,SARDEGNA,Residenti,185,527,1282,1441,3649,7084
2,2022,SENEGAL,AIRE,0,0,1,0,0,1
2,2022,SERBIA,AIRE,0,0,2,0,0,2
2,2022,SICILIA,Residenti,825,1890,3728,5154,11345,22942
2,2022,SINGAPORE,AIRE,2,3,2,1,19,27
2,2022,SLOVACCHIA,AIRE,0,0,0,2,10,12
2,2022,SLOVENIA,AIRE,0,0,1,6,1,8
2,2022,SPAGNA,AIRE,43,21,106,123,139,432
2,2022,STATI UNITI D'AMERICA,AIRE,16,12,23,39,64,154
2,2022,SVEZIA,AIRE,2,1,3,7,4,17
2,2022,SVIZZERA,AIRE,40,33,76,106,159,414
2,2022,TERRITORI DELL'AUTONOMIA PALESTINESE,AIRE,0,4,0,0,0,4
2,2022,THAILANDIA,AIRE,1,2,1,1,0,5
2,2022,TOSCANA,Residenti,497,1657,3222,3919,9230,18525
2,2022,TRENTINO ALTO ADIGE,Residenti,99,252,990,932,1919,4192
2,2022,TUNISIA,AIRE,10,1,17,13,17,58
2,2022,TURCHIA,AIRE,1,1,3,1,0,6
2,2022,UCRAINA,AIRE,2,0,3,1,2,8
2,2022,UGANDA,AIRE,0,1,0,0,0,1
2,2022,UMBRIA,Residenti,110,250,856,1043,2526,4785
2,2022,UNGHERIA,AIRE,0,1,1,5,14,21
2,2022,URUGUAY,AIRE,0,0,0,3,0,3
2,2022,VALLE D'AOSTA,Residenti,17,18,92,110,194,431
2,2022,VENETO,Residenti,488,1369,5796,5865,14703,28221
2,2022,VENEZUELA,AIRE,0,0,2,20,6,28
2,2022,VIETNAM,AIRE,0,0,1,0,4,5
3,2022,ABRUZZO,Residenti,117,284,882,1080,2660,5023
3,2022,AFGHANISTAN,AIRE,0,0,0,0,1,1
3,2022,ALGERIA,AIRE,0,4,0,2,1,7
3,2022,ARABIA SAUDITA,AIRE,1,0,1,3,1,6
3,2022,ARGENTINA,AIRE,11,3,8,22,21,65
3,2022,ARMENIA,AIRE,0,0,1,0,0,1
3,2022,AUSTRALIA,AIRE,5,9,6,5,10,35
3,2022,AUSTRIA,AIRE,4,4,13,17,20,58
3,2022,BAHREIN,AIRE,0,0,1,0,5,6
3,2022,BANGLADESH,AIRE,0,0,1,0,0,1
3,2022,BASILICATA,Residenti,53,177,375,454,1217,2276
3,2022,BELGIO,AIRE,10,5,21,23,33,92
3,2022,BOLIVIA,AIRE,1,0,3,0,0,4
3,2022,BOSNIA-ERZEGOVINA,AIRE,2,0,0,0,0,2
3,2022,BRASILE,AIRE,29,8,54,119,56,266
3,2022,BULGARIA,AIRE,1,3,1,4,6,15
3,2022,CALABRIA,Residenti,344,537,1405,1909,4562,8757
3,2022,CAMERUN,AIRE,0,1,0,0,0,1
3,2022,CAMPANIA,Residenti,977,1742,4293,6091,17130,30233
3,2022,CANADA,AIRE,0,2,1,3,0,6
3,2022,CILE,AIRE,1,0,4,1,4,10
3,2022,CIPRO,AIRE,2,0,3,0,4,9
3,2022,COLOMBIA,AIRE,0,0,1,2,2,5
3,2022,COSTA D'AVORIO,AIRE,0,0,2,0,0,2
3,2022,COSTA RICA,AIRE,0,0,0,2,0,2
3,2022,CROAZIA,AIRE,2,1,2,0,2,7
3,2022,CUBA,AIRE,0,0,0,0,2,2
3,2022,DANIMARCA,AIRE,3,8,1,1,2,15
3,2022,ECUADOR,AIRE,0,0,1,0,0,1
3,2022,EGITTO,AIRE,0,2,1,1,2,6
3,2022,EMILIA ROMAGNA,Residenti,576,1798,5484,5776,16706,30340
3,2022,EMIRATI ARABI UNITI,AIRE,8,6,12,21,9,56
3,2022,FEDERAZIONE RUSSA,AIRE,0,2,4,1,8,15
3,2022,FILIPPINE,AIRE,0,0,3,0,1,4
3,2022,FINLANDIA,AIRE,1,0,2,17,4,24
3,2022,FRANCIA,AIRE,37,23,102,169,195,526
3,2022,FRIULI VENEZIA GIULIA,Residenti,97,245,1185,1212,3333,6072
3,2022,GEORGIA,AIRE,0,0,0,0,2,2
3,2022,GERMANIA,AIRE,21,39,88,104,138,390
3,2022,GIAPPONE,AIRE,7,0,0,2,4,13
3,2022,GIORDANIA,AIRE,0,0,1,4,1,6
3,2022,GRECIA,AIRE,4,1,8,10,15,38
3,2022,GRENADA,AIRE,0,0,2,0,0,2
3,2022,GUINEA EQUATORIALE,AIRE,0,1,0,0,0,1
3,2022,IGNOTO,AIRE,0,0,1,1,13,15
3,2022,INDIA,AIRE,0,0,1,0,0,1
3,2022,INDONESIA,AIRE,4,1,0,0,0,5
3,2022,IRLANDA,AIRE,6,8,12,7,16,49
3,2022,ISRAELE,AIRE,1,0,1,1,4,7
3,2022,KAZAKHSTAN,AIRE,0,0,3,0,0,3
3,2022,KENYA,AIRE,0,0,2,1,4,7
3,2022,KUWAIT,AIRE,1,0,1,0,0,2
3,2022,LAZIO,Residenti,1345,3438,4820,7702,16788,34093
3,2022,LETTONIA,AIRE,0,0,0,3,0,3
3,2022,LIGURIA,Residenti,191,458,1118,1493,4141,7401
3,2022,LITUANIA,AIRE,1,3,0,0,1,5
3,2022,LOMBARDIA,Residenti,1380,3019,10624,11617,38222,64862
3,2022,LUSSEMBURGO,AIRE,1,3,5,9,22,40
3,2022,MADAGASCAR,AIRE,0,0,0,1,0,1
3,2022,MALAYSIA,AIRE,0,1,0,1,0,2
3,2022,MALTA,AIRE,6,2,1,0,2,11
3,2022,MARCHE,Residenti,151,496,1249,1283,3746,6925
3,2022,MAROCCO,AIRE,1,1,2,2,2,8
3,2022,MESSICO,AIRE,2,0,2,4,0,8
3,2022,MOLDOVA,AIRE,0,0,1,0,0,1
3,2022,MOLISE,Residenti,20,46,231,286,637,1220
3,2022,MONACO,AIRE,1,0,1,1,8,11
3,2022,MONTENEGRO,AIRE,0,0,0,0,3,3
3,2022,NIGERIA,AIRE,0,0,0,0,1,1
3,2022,NORVEGIA,AIRE,1,0,3,5,8,17
3,2022,NUOVA ZELANDA,AIRE,0,6,0,0,0,6
3,2022,PAESI BASSI,AIRE,12,3,17,23,24,79
3,2022,PANAMA,AIRE,0,0,0,0,2,2
3,2022,PERU',AIRE,0,2,0,0,0,2
3,2022,PIEMONTE,Residenti,484,1282,3717,4137,12451,22071
3,2022,POLONIA,AIRE,2,2,7,12,14,37
3,2022,PORTOGALLO,AIRE,10,3,26,25,22,86
3,2022,PUGLIA,Residenti,457,1083,2694,3548,10359,18141
3,2022,QATAR,AIRE,1,1,4,6,6,18
3,2022,REGNO UNITO,AIRE,66,48,112,184,146,556
3,2022,REPUBBLICA CECA,AIRE,0,0,7,1,5,13
3,2022,REPUBBLICA DI COREA,AIRE,0,0,0,0,4,4
3,2022,REPUBBLICA DOMINICANA,AIRE,2,2,10,34,8,56
3,2022,REPUBBLICA POPOLARE CINESE,AIRE,5,1,9,8,4,27
3,2022,ROMANIA,AIRE,5,1,5,9,5,25
3,2022,SAN MARINO,AIRE,0,2,1,0,3,6
3,2022,SARDEGNA,Residenti,194,478,1394,1645,4047,7758
3,2022,SERBIA,AIRE,0,0,0,1,0,1
3,2022,SICILIA,Residenti,781,1677,3602,5209,11743,23012
3,2022,SINGAPORE,AIRE,0,0,4,2,1,7
3,2022,SLOVACCHIA,AIRE,1,0,10,5,6,22
3,2022,SLOVENIA,AIRE,1,1,9,7,7,25
3,2022,SPAGNA,AIRE,44,20,103,110,122,399
3,2022,STATI UNITI D'AMERICA,AIRE,11,8,44,53,56,172
3,2022,SUD AFRICA,AIRE,0,0,0,0,4,4
3,2022,SVEZIA,AIRE,3,4,6,9,7,29
3,2022,SVIZZERA,AIRE,24,6,69,77,126,302
3,2022,THAILANDIA,AIRE,5,0,4,11,4,24
3,2022,TOSCANA,Residenti,420,1325,3300,3735,10195,18975
3,2022,TRENTINO ALTO ADIGE,Residenti,97,313,947,981,2098,4436
3,2022,TUNISIA,AIRE,4,1,18,12,20,55
3,2022,TURCHIA,AIRE,0,0,2,0,3,5
3,2022,UCRAINA,AIRE,0,0,1,0,1,2
3,2022,UMBRIA,Residenti,74,223,730,884,2499,4410
3,2022,UNGHERIA,AIRE,3,2,2,8,6,21
3,2022,VALLE D'AOSTA,Residenti,3,10,90,77,266,446
3,2022,VENETO,Residenti,464,1618,5283,5306,14936,27607
3,2022,VENEZUELA,AIRE,1,0,3,6,0,10
3,2022,VIETNAM,AIRE,1,1,4,4,6,16
4,2022,ABRUZZO,Residenti,125,456,645,872,2189,4287
4,2022,ALBANIA,AIRE,2,2,1,6,9,20
4,2022,ALGERIA,AIRE,0,0,0,0,1,1
4,2022,ANGOLA,AIRE,0,1,1,0,8,10
4,2022,ARABIA SAUDITA,AIRE,1,0,3,0,5,9
4,2022,ARGENTINA,AIRE,4,11,21,28,19,83
4,2022,AUSTRALIA,AIRE,7,8,8,9,12,44
4,2022,AUSTRIA,AIRE,0,7,10,15,13,45
4,2022,BAHREIN,AIRE,0,0,2,1,2,5
4,2022,BANGLADESH,AIRE,0,2,0,0,0,2
4,2022,BASILICATA,Residenti,57,231,342,441,926,1997
4,2022,BELGIO,AIRE,9,9,18,24,18,78
4,2022,BRASILE,AIRE,22,15,37,75,41,190
4,2022,BULGARIA,AIRE,0,2,9,1,2,14
4,2022,CALABRIA,Residenti,268,736,1207,1579,3419,7209
4,2022,CAMERUN,AIRE,0,0,1,1,1,3
4,2022,CAMPANIA,Residenti,796,1942,3440,5599,13790,25567
4,2022,CANADA,AIRE,1,1,3,3,3,11
4,2022,CIAD,AIRE,0,0,0,0,2,2
4,2022,CILE,AIRE,5,3,0,6,3,17
4,2022,CIPRO,AIRE,1,0,3,1,2,7
4,2022,COLOMBIA,AIRE,0,1,0,2,1,4
4,2022,CONGO,AIRE,0,0,1,0,0,1
4,2022,COSTA RICA,AIRE,0,1,0,0,0,1
4,2022,CROAZIA,AIRE,0,0,0,1,3,4
4,2022,CUBA,AIRE,1,0,0,0,0,1
4,2022,DANIMARCA,AIRE,4,3,11,8,1,27
4,2022,ECUADOR,AIRE,1,2,1,1,13,18
4,2022,EGITTO,AIRE,0,2,0,2,2,6
4,2022,EMILIA ROMAGNA,Residenti,562,1890,4202,4824,13695,25173
4,2022,EMIRATI ARABI UNITI,AIRE,3,3,12,10,12,40
4,2022,ESTONIA,AIRE,0,0,1,0,0,1
4,2022,FEDERAZIONE RUSSA,AIRE,3,1,2,4,3,13
4,2022,FILIPPINE,AIRE,0,0,0,2,1,3
4,2022,FINLANDIA,AIRE,1,0,3,6,5,15
4,2022,FRANCIA,AIRE,35,31,70,105,134,375
4,2022,FRIULI VENEZIA GIULIA,Residenti,103,299,982,1005,2538,4927
4,2022,GERMANIA,AIRE,45,105,69,117,106,442
4,2022,GIAPPONE,AIRE,1,0,6,2,4,13
4,2022,GIORDANIA,AIRE,0,0,1,3,1,5
4,2022,GRECIA,AIRE,3,5,6,6,15,35
4,2022,GRENADA,AIRE,0,0,1,0,1,2
4,2022,IGNOTO,AIRE,0,1,0,2,1,4
4,2022,INDONESIA,AIRE,2,2,0,0,2,6
4,2022,IRLANDA,AIRE,7,7,10,17,30,71
4,2022,ISLANDA,AIRE,0,0,1,0,1,2
4,2022,ISRAELE,AIRE,1,0,0,1,1,3
4,2022,KAZAKHSTAN,AIRE,0,1,0,0,0,1
4,2022,KENYA,AIRE,0,2,0,1,2,5
4,2022,LAZIO,Residenti,1065,3319,3797,6354,13327,27862
4,2022,LESOTHO,AIRE,0,0,0,1,1,2
4,2022,LETTONIA,AIRE,1,0,1,1,2,5
4,2022,LIGURIA,Residenti,119,447,934,1198,3634,6332
4,2022,LOMBARDIA,Residenti,1241,3661,8619,9784,31259,54564
4,2022,LUSSEMBURGO,AIRE,5,4,12,8,12,41
4,2022,MACEDONIA DEL NORD,AIRE,0,0,0,1,3,4
4,2022,MADAGASCAR,AIRE,0,0,0,2,1,3
4,2022,MALAYSIA,AIRE,0,0,1,3,0,4
4,2022,MALI,AIRE,1,0,1,0,0,2
4,2022,MALTA,AIRE,1,2,3,5,9,20
4,2022,MARCHE,Residenti,128,479,963,1099,2959,5628
4,2022,MAROCCO,AIRE,1,1,4,0,0,6
4,2022,MAURITIUS,AIRE,0,0,0,0,1,1
4,2022,MESSICO,AIRE,0,3,1,3,1,8
4,2022,MOLDOVA,AIRE,1,1,0,2,1,5
4,2022,MOLISE,Residenti,18,79,124,203,460,884
4,2022,MONACO,AIRE,3,0,0,3,8,14
4,2022,MONTENEGRO,AIRE,1,2,1,0,3,7
4,2022,MOZAMBICO,AIRE,0,0,1,0,0,1
4,2022,MYANMAR,AIRE,1,0,0,0,0,1
4,2022,NORVEGIA,AIRE,2,4,3,3,0,12
4,2022,PAESI BASSI,AIRE,3,17,22,26,25,93
4,2022,PANAMA,AIRE,2,1,3,0,8,14
4,2022,PERU',AIRE,0,0,0,0,2,2
4,2022,PIEMONTE,Residenti,432,1478,3108,3890,10214,19122
4,2022,POLONIA,AIRE,2,4,7,3,7,23
4,2022,PORTOGALLO,AIRE,10,7,30,39,39,125
4,2022,PUGLIA,Residenti,435,1412,2176,3258,8284,15565
4,2022,QATAR,AIRE,0,7,2,6,10,25
4,2022,REGNO UNITO,AIRE,49,69,144,207,251,720
4,2022,REPUBBLICA CECA,AIRE,6,4,8,9,10,37
4,2022,REPUBBLICA DOMINICANA,AIRE,2,0,5,4,1,12
4,2022,REPUBBLICA POPOLARE CINESE,AIRE,2,3,10,10,16,41
4,2022,ROMANIA,AIRE,5,1,10,12,19,47
4,2022,SAN MARINO,AIRE,3,0,2,4,4,13
4,2022,SARDEGNA,Residenti,186,592,1025,1362,3070,6235
4,2022,SENEGAL,AIRE,0,0,0,1,0,1
4,2022,SICILIA,Residenti,651,2040,2870,4415,9729,19705
4,2022,SIERRA LEONE,AIRE,0,0,1,0,0,1
4,2022,SINGAPORE,AIRE,3,1,4,6,5,19
4,2022,SLOVACCHIA,AIRE,1,0,1,6,2,10
4,2022,SLOVENIA,AIRE,0,0,3,0,0,3
4,2022,SPAGNA,AIRE,30,22,66,80,122,320
4,2022,STATI UNITI D'AMERICA,AIRE,16,27,31,58,63,195
4,2022,SUD SUDAN,AIRE,4,0,1,0,0,5
4,2022,SVEZIA,AIRE,0,1,2,8,7,18
4,2022,SVIZZERA,AIRE,24,22,89,105,124,364
4,2022,TAGIKISTAN,AIRE,0,0,1,1,0,2
4,2022,THAILANDIA,AIRE,0,1,1,4,8,14
4,2022,TOSCANA,Residenti,396,1338,2630,3159,7897,15420
4,2022,TRENTINO ALTO ADIGE,Residenti,76,275,703,724,1635,3413
4,2022,TUNISIA,AIRE,7,5,4,22,15,53
4,2022,TURCHIA,AIRE,1,0,1,5,0,7
4,2022,UCRAINA,AIRE,0,3,3,1,1,8
4,2022,UGANDA,AIRE,0,0,0,0,1,1
4,2022,UMBRIA,Residenti,88,279,592,664,1929,3552
4,2022,UNGHERIA,AIRE,4,0,0,2,5,11
4,2022,UZBEKISTAN,AIRE,0,1,4,0,3,8
4,2022,VALLE D'AOSTA,Residenti,3,32,85,113,272,505
4,2022,VENETO,Residenti,437,1927,4025,4400,12129,22918
4,2022,VENEZUELA,AIRE,0,1,2,3,0,6
5,2022,ABRUZZO,Residenti,183,842,822,1128,2540,5515
5,2022,ALBANIA,AIRE,0,1,1,6,2,10
5,2022,ALGERIA,AIRE,0,1,3,0,4,8
5,2022,ARABIA SAUDITA,AIRE,1,0,3,0,7,11
5,2022,ARGENTINA,AIRE,2,0,13,18,12,45
5,2022,AUSTRALIA,AIRE,1,19,11,8,27,66
5,2022,AUSTRIA,AIRE,4,6,7,15,22,54
5,2022,BAHREIN,AIRE,0,0,1,0,5,6
5,2022,BANGLADESH,AIRE,0,0,0,0,1,1
5,2022,BARBADOS,AIRE,0,0,0,1,5,6
5,2022,BASILICATA,Residenti,65,293,318,447,1078,2201
5,2022,BELGIO,AIRE,7,10,10,19,24,70
5,2022,BENIN,AIRE,0,0,0,0,3,3
5,2022,BOSNIA-ERZEGOVINA,AIRE,0,0,0,0,6,6
5,2022,BRASILE,AIRE,12,9,30,56,38,145
5,2022,BULGARIA,AIRE,0,2,5,0,6,13
5,2022,CALABRIA,Residenti,362,1261,1178,1801,4250,8852
5,2022,CAMERUN,AIRE,2,1,0,3,3,9
5,2022,CAMPANIA,Residenti,980,3291,4018,6572,16140,31001
5,2022,CANADA,AIRE,3,1,3,32,2,41
5,2022,CAPO VERDE,AIRE,0,1,0,0,6,7
5,2022,CIAD,AIRE,0,0,2,2,4,8
5,2022,CILE,AIRE,2,0,2,2,4,10
5,2022,CIPRO,AIRE,0,0,3,0,2,5
5,2022,COLOMBIA,AIRE,0,1,1,3,5,10
5,2022,COSTA RICA,AIRE,0,0,2,3,6,11
5,2022,CROAZIA,AIRE,1,0,0,0,4,5
5,2022,CUBA,AIRE,2,0,3,0,0,5
5,2022,DANIMARCA,AIRE,1,1,4,9,3,18
5,2022,EGITTO,AIRE,2,0,2,2,4,10
5,2022,EMILIA ROMAGNA,Residenti,617,3280,4952,5663,16125,30637
5,2022,EMIRATI ARABI UNITI,AIRE,3,4,11,9,21,48
5,2022,FEDERAZIONE RUSSA,AIRE,6,3,4,5,7,25
5,2022,FILIPPINE,AIRE,0,0,0,2,4,6
5,2022,FINLANDIA,AIRE,0,3,6,2,5,16
5,2022,FRANCIA,AIRE,37,29,97,85,196,444
5,2022,FRIULI VENEZIA GIULIA,Residenti,108,688,1131,1207,2967,6101
5,2022,GABON,AIRE,0,4,0,0,0,4
5,2022,GERMANIA,AIRE,55,55,57,124,116,407
5,2022,GIAPPONE,AIRE,0,0,0,1,2,3
5,2022,GIBILTERRA,AIRE,1,0,0,0,0,1
5,2022,GIORDANIA,AIRE,0,0,0,0,1,1
5,2022,GRECIA,AIRE,0,2,2,3,11,18
5,2022,GUATEMALA,AIRE,0,0,0,1,0,1
5,2022,IGNOTO,AIRE,2,0,0,4,1,7
5,2022,INDONESIA,AIRE,0,0,0,1,0,1
5,2022,IRAQ,AIRE,3,0,0,1,8,12
5,2022,IRLANDA,AIRE,14,19,15,19,11,78
5,2022,ISRAELE,AIRE,4,1,0,0,3,8
5,2022,KAZAKHSTAN,AIRE,0,0,0,3,3,6
5,2022,KENYA,AIRE,0,0,1,0,0,1
5,2022,LAZIO,Residenti,1287,4683,4356,7403,15801,33530
5,2022,LIBANO,AIRE,0,0,0,1,2,3
5,2022,LIGURIA,Residenti,196,1006,1095,1431,3851,7579
5,2022,LITUANIA,AIRE,0,0,1,0,1,2
5,2022,LOMBARDIA,Residenti,1441,7257,9665,11416,35835,65614
5,2022,LUSSEMBURGO,AIRE,5,4,10,10,9,38
5,2022,MALAYSIA,AIRE,0,1,2,1,2,6
5,2022,MALI,AIRE,0,0,1,0,1,2
5,2022,MALTA,AIRE,2,6,5,10,12,35
5,2022,MARCHE,Residenti,154,833,1053,1289,3489,6818
5,2022,MAROCCO,AIRE,0,1,1,7,1,10
5,2022,MAURITIUS,AIRE,0,0,0,1,0,1
5,2022,MESSICO,AIRE,0,1,2,0,8,11
5,2022,MOLISE,Residenti,32,165,185,228,522,1132
5,2022,MONACO,AIRE,1,0,0,0,7,8
5,2022,MOZAMBICO,AIRE,1,0,1,1,0,3
5,2022,MYANMAR,AIRE,2,0,0,0,0,2
5,2022,NORVEGIA,AIRE,0,4,3,8,3,18
5,2022,PAESI BASSI,AIRE,6,11,11,21,21,70
5,2022,PANAMA,AIRE,0,0,1,1,1,3
5,2022,PARAGUAY,AIRE,0,0,0,0,2,2
5,2022,PERU',AIRE,4,2,2,5,1,14
5,2022,PIEMONTE,Residenti,535,2900,3304,4475,11337,22551
5,2022,POLONIA,AIRE,5,5,3,7,9,29
5,2022,PORTOGALLO,AIRE,8,5,24,22,36,95
5,2022,PUGLIA,Residenti,441,2531,2382,3569,9420,18343
5,2022,QATAR,AIRE,1,1,0,4,3,9
5,2022,REGNO UNITO,AIRE,54,106,118,185,177,640
5,2022,REPUBBLICA CECA,AIRE,7,1,4,8,9,29
5,2022,REPUBBLICA DI COREA,AIRE,3,2,3,3,4,15
5,2022,REPUBBLICA DOMINICANA,AIRE,1,1,1,6,3,12
5,2022,REPUBBLICA POPOLARE CINESE,AIRE,4,6,12,12,19,53
5,2022,REPUBBLICA POPOLARE DEMOCRATICA DI COREA,AIRE,0,0,0,2,0,2
5,2022,ROMANIA,AIRE,2,3,3,1,18,27
5,2022,SAN MARINO,AIRE,0,0,0,7,7,14
5,2022,SARDEGNA,Residenti,235,1450,1234,1804,3628,8351
5,2022,SERBIA,AIRE,0,0,0,0,1,1
5,2022,SICILIA,Residenti,1107,5895,3378,5787,11672,27839
5,2022,SINGAPORE,AIRE,2,2,2,3,9,18
5,2022,SLOVACCHIA,AIRE,1,0,2,8,4,15
5,2022,SLOVENIA,AIRE,0,0,4,1,1,6
5,2022,SPAGNA,AIRE,28,41,98,110,108,385
5,2022,STATI UNITI D'AMERICA,AIRE,14,23,30,59,93,219
5,2022,SUD AFRICA,AIRE,0,0,0,0,1,1
5,2022,SVEZIA,AIRE,3,4,6,5,7,25
5,2022,SVIZZERA,AIRE,32,32,75,97,119,355
5,2022,TAIWAN,AIRE,1,0,0,2,0,3
5,2022,THAILANDIA,AIRE,1,1,2,3,11,18
5,2022,TOSCANA,Residenti,433,2553,2850,3685,9007,18528
5,2022,TRENTINO ALTO ADIGE,Residenti,114,419,779,796,1902,4010
5,2022,TUNISIA,AIRE,6,7,19,6,18,56
5,2022,TURCHIA,AIRE,0,0,2,0,0,2
5,2022,UCRAINA,AIRE,0,0,0,0,1,1
5,2022,UGANDA,AIRE,0,1,2,2,1,6
5,2022,UMBRIA,Residenti,151,888,719,936,2425,5119
5,2022,UNGHERIA,AIRE,0,0,2,5,0,7
5,2022,URUGUAY,AIRE,0,0,1,2,16,19
5,2022,VALLE D'AOSTA,Residenti,8,60,88,77,254,487
5,2022,VENETO,Residenti,519,3705,4719,4886,13835,27664
5,2022,VENEZUELA,AIRE,0,3,3,4,6,16
5,2022,VIETNAM,AIRE,0,0,1,0,0,1
6,2022,ABRUZZO,Residenti,142,892,743,963,2250,4990
6,2022,ALBANIA,AIRE,1,2,1,2,4,10
6,2022,ALGERIA,AIRE,0,0,0,0,1,1
6,2022,ARABIA SAUDITA,AIRE,1,0,6,0,4,11
6,2022,ARGENTINA,AIRE,5,0,13,13,23,54
6,2022,AUSTRALIA,AIRE,4,2,11,10,31,58
6,2022,AUSTRIA,AIRE,4,5,7,13,15,44
6,2022,BAHREIN,AIRE,0,0,4,5,14,23
6,2022,BASILICATA,Residenti,50,333,351,421,1024,2179
6,2022,BELGIO,AIRE,7,7,20,17,58,109
6,2022,BIELORUSSIA,AIRE,0,0,0,0,4,4
6,2022,BOSNIA-ERZEGOVINA,AIRE,0,0,1,4,1,6
6,2022,BRASILE,AIRE,10,12,53,92,53,220
6,2022,BULGARIA,AIRE,2,2,4,10,8,26
6,2022,CALABRIA,Residenti,296,1064,1252,1742,3962,8316
6,2022,CAMERUN,AIRE,1,2,3,19,2,27
6,2022,CAMPANIA,Residenti,854,2855,3473,5503,14928,27613
6,2022,CANADA,AIRE,2,2,5,3,6,18
6,2022,CILE,AIRE,3,1,1,1,0,6
6,2022,CIPRO,AIRE,2,1,3,2,5,13
6,2022,COLOMBIA,AIRE,1,1,3,0,2,7
6,2022,COSTA D'AVORIO,AIRE,0,1,0,0,0,1
6,2022,CROAZIA,AIRE,1,2,0,1,2,6
6,2022,CUBA,AIRE,0,0,4,0,1,5
6,2022,DANIMARCA,AIRE,2,0,0,10,3,15
6,2022,ECUADOR,AIRE,0,0,0,1,3,4
6,2022,EGITTO,AIRE,1,0,3,6,7,17
6,2022,EMILIA ROMAGNA,Residenti,492,3300,4578,4958,14763,28091
6,2022,EMIRATI ARABI UNITI,AIRE,9,2,16,9,21,57
6,2022,ERITREA,AIRE,0,0,1,0,0,1
6,2022,ESTONIA,AIRE,0,2,3,1,2,8
6,2022,FEDERAZIONE RUSSA,AIRE,0,0,0,2,8,10
6,2022,FILIPPINE,AIRE,1,0,1,0,1,3
6,2022,FINLANDIA,AIRE,1,1,2,5,4,13
6,2022,FRANCIA,AIRE,47,25,83,67,129,351
6,2022,FRIULI VENEZIA GIULIA,Residenti,95,710,1005,1057,2962,5829
6,2022,GABON,AIRE,0,1,0,0,0,1
6,2022,GEORGIA,AIRE,0,1,0,0,0,1
6,2022,GERMANIA,AIRE,29,50,58,76,86,299
6,2022,GIAPPONE,AIRE,2,1,1,4,2,10
6,2022,GIORDANIA,AIRE,1,0,1,1,1,4
6,2022,GRECIA,AIRE,1,1,0,1,5,8
6,2022,GUADALUPA,AIRE,0,0,0,2,2,4
6,2022,IGNOTO,AIRE,0,2,3,1,1,7
6,2022,INDIA,AIRE,0,0,1,0,0,1
6,2022,IRAQ,AIRE,0,1,0,1,0,2
6,2022,IRLANDA,AIRE,11,10,15,49,28,113
6,2022,ISLANDA,AIRE,1,1,0,1,1,4
6,2022,ISRAELE,AIRE,0,0,0,0,4,4
6,2022,KENYA,AIRE,0,0,1,0,0,1
6,2022,KUWAIT,AIRE,0,0,1,0,0,1
6,2022,LAZIO,Residenti,1031,4063,3837,6295,14582,29808
6,2022,LIBANO,AIRE,0,0,1,0,1,2
6,2022,LIGURIA,Residenti,174,934,1093,1224,3419,6844
6,2022,LOMBARDIA,Residenti,1370,7221,8950,10610,34024,62175
6,2022,LUSSEMBURGO,AIRE,6,7,7,28,21,69
6,2022,MACEDONIA DEL NORD,AIRE,0,0,1,1,0,2
6,2022,MALAYSIA,AIRE,0,0,0,0,2,2
6,2022,MALDIVE,AIRE,0,1,0,0,0,1
6,2022,MALTA,AIRE,9,9,7,22,14,61
6,2022,MARCHE,Residenti,128,849,994,1089,3170,6230
6,2022,MAROCCO,AIRE,3,0,5,2,16,26
6,2022,MESSICO,AIRE,2,3,1,6,5,17
6,2022,MOLDOVA,AIRE,0,0,0,1,1,2
6,2022,MOLISE,Residenti,37,177,183,203,510,1110
6,2022,MONACO,AIRE,0,2,3,2,4,11
6,2022,MONTENEGRO,AIRE,0,0,0,0,1,1
6,2022,MOZAMBICO,AIRE,0,1,1,0,1,3
6,2022,MYANMAR,AIRE,0,0,1,0,0,1
6,2022,NEPAL,AIRE,0,0,1,0,0,1
6,2022,NIGERIA,AIRE,0,0,0,0,1,1
6,2022,NORVEGIA,AIRE,0,0,4,2,4,10
6,2022,NUOVA ZELANDA,AIRE,2,1,0,2,3,8
6,2022,PAESI BASSI,AIRE,6,9,17,28,26,86
6,2022,PAKISTAN,AIRE,0,0,0,2,0,2
6,2022,PANAMA,AIRE,1,0,0,0,0,1
6,2022,PERU',AIRE,0,0,1,0,0,1
6,2022,PIEMONTE,Residenti,499,2704,3018,3841,11063,21125
6,2022,POLONIA,AIRE,5,3,8,15,2,33
6,2022,PORTOGALLO,AIRE,15,7,18,37,35,112
6,2022,PUGLIA,Residenti,457,2300,2132,3065,8338,16292
6,2022,QATAR,AIRE,0,0,3,15,15,33
6,2022,REGNO UNITO,AIRE,62,85,93,180,156,576
6,2022,REPUBBLICA CECA,AIRE,7,4,9,26,11,57
6,2022,REPUBBLICA DI COREA,AIRE,0,0,2,0,0,2
6,2022,REPUBBLICA DOMINICANA,AIRE,2,5,4,0,1,12
6,2022,REPUBBLICA POPOLARE CINESE,AIRE,7,4,12,27,18,68
6,2022,ROMANIA,AIRE,1,2,4,16,15,38
6,2022,SAN MARINO,AIRE,2,5,3,9,8,27
6,2022,SARDEGNA,Residenti,207,1192,1083,1529,3524,7535
6,2022,SENEGAL,AIRE,0,0,0,0,1,1
6,2022,SERBIA,AIRE,0,0,3,0,0,3
6,2022,SEYCHELLES,AIRE,0,0,0,1,0,1
6,2022,SICILIA,Residenti,964,5370,2810,4881,10401,24426
6,2022,SINGAPORE,AIRE,0,0,6,3,3,12
6,2022,SLOVACCHIA,AIRE,0,0,0,0,9,9
6,2022,SLOVENIA,AIRE,1,5,3,6,4,19
6,2022,SPAGNA,AIRE,30,27,92,103,89,341
6,2022,STATI UNITI D'AMERICA,AIRE,11,12,23,63,43,152
6,2022,SUD AFRICA,AIRE,0,0,0,0,1,1
6,2022,SVEZIA,AIRE,2,1,11,5,10,29
6,2022,SVIZZERA,AIRE,37,23,64,79,109,312
6,2022,THAILANDIA,AIRE,0,1,1,1,8,11
6,2022,TOSCANA,Residenti,450,2604,2751,3350,8781,17936
6,2022,TRENTINO ALTO ADIGE,Residenti,90,398,745,656,1499,3388
6,2022,TUNISIA,AIRE,6,2,8,32,30,78
6,2022,TURCHIA,AIRE,1,0,1,1,1,4
6,2022,UCRAINA,AIRE,0,2,0,0,0,2
6,2022,UGANDA,AIRE,0,0,1,0,0,1
6,2022,UMBRIA,Residenti,117,906,681,904,2172,4780
6,2022,UNGHERIA,AIRE,0,2,8,2,4,16
6,2022,URUGUAY,AIRE,0,0,0,0,1,1
6,2022,UZBEKISTAN,AIRE,0,1,1,1,2,5
6,2022,VALLE D'AOSTA,Residenti,3,35,61,80,206,385
6,2022,VENETO,Residenti,502,3680,4304,4714,12885,26085
6,2022,VENEZUELA,AIRE,2,4,8,7,3,24
6,2022,VIETNAM,AIRE,0,0,1,0,0,1
7,2022,ABRUZZO,Residenti,162,936,713,1091,2011,4913
7,2022,ALBANIA,AIRE,1,0,3,1,4,9
7,2022,ANDORRA,AIRE,3,0,1,0,0,4
7,2022,ANGOLA,AIRE,1,1,0,0,0,2
7,2022,ARABIA SAUDITA,AIRE,1,2,2,3,3,11
7,2022,ARGENTINA,AIRE,4,5,16,18,5,48
7,2022,AUSTRALIA,AIRE,3,5,5,6,17,36
7,2022,AUSTRIA,AIRE,1,1,10,18,31,61
7,2022,AZERBAIGIAN,AIRE,0,0,0,0,3,3
7,2022,BAHAMAS,AIRE,0,2,0,0,0,2
7,2022,BAHREIN,AIRE,0,0,0,0,1,1
7,2022,BASILICATA,Residenti,50,295,277,408,810,1840
7,2022,BELGIO,AIRE,4,8,21,26,35,94
7,2022,BRASILE,AIRE,15,8,31,69,37,160
7,2022,BULGARIA,AIRE,2,0,6,10,10,28
7,2022,BURKINA FASO,AIRE,0,0,2,0,0,2
7,2022,CALABRIA,Residenti,284,1089,1051,1584,3289,7297
7,2022,CAMBOGIA,AIRE,0,1,4,0,0,5
7,2022,CAMERUN,AIRE,0,4,0,0,0,4
7,2022,CAMPANIA,Residenti,885,3191,3311,5500,13463,26350
7,2022,CANADA,AIRE,0,1,3,4,4,12
7,2022,CILE,AIRE,0,6,2,5,0,13
7,2022,CIPRO,AIRE,0,0,0,0,3,3
7,2022,COLOMBIA,AIRE,0,1,2,3,1,7
7,2022,COSTA D'AVORIO,AIRE,0,0,0,0,3,3
7,2022,CROAZIA,AIRE,1,1,0,0,6,8
7,2022,DANIMARCA,AIRE,0,5,4,3,7,19
7,2022,ECUADOR,AIRE,0,0,4,0,1,5
7,2022,EGITTO,AIRE,3,1,1,2,2,9
7,2022,EMILIA ROMAGNA,Residenti,499,3398,4002,4753,13997,26649
7,2022,EMIRATI ARABI UNITI,AIRE,3,2,13,8,14,40
7,2022,ESTONIA,AIRE,1,5,1,0,0,7
7,2022,FEDERAZIONE RUSSA,AIRE,2,1,5,1,17,26
7,2022,FILIPPINE,AIRE,0,0,1,0,1,2
7,2022,FINLANDIA,AIRE,1,1,0,1,2,5
7,2022,FRANCIA,AIRE,39,27,60,75,118,319
7,2022,FRIULI VENEZIA GIULIA,Residenti,102,638,977,1141,3040,5898
7,2022,GEORGIA,AIRE,0,0,0,0,1,1
7,2022,GERMANIA,AIRE,26,48,56,97,169,396
7,2022,GIAPPONE,AIRE,4,0,1,3,3,11
7,2022,GIBILTERRA,AIRE,1,0,1,1,3,6
7,2022,GIORDANIA,AIRE,1,2,0,1,0,4
7,2022,GRECIA,AIRE,5,3,3,6,21,38
7,2022,GUATEMALA,AIRE,0,0,1,5,0,6
7,2022,GUINEA BISSAU,AIRE,0,0,1,1,0,2
7,2022,IGNOTO,AIRE,0,0,1,1,10,12
7,2022,INDONESIA,AIRE,0,1,3,1,0,5
7,2022,IRAN,AIRE,0,0,1,0,0,1
7,2022,IRAQ,AIRE,1,1,3,5,2,12
7,2022,IRLANDA,AIRE,8,5,12,25,28,78
7,2022,ISRAELE,AIRE,0,1,3,7,3,14
7,2022,KENYA,AIRE,0,0,2,1,1,4
7,2022,KUWAIT,AIRE,0,0,1,0,0,1
7,2022,LAZIO,Residenti,1168,4162,3657,6189,13475,28651
7,2022,LETTONIA,AIRE,0,0,0,4,0,4
7,2022,LIGURIA,Residenti,168,856,933,1223,3435,6615
7,2022,LITUANIA,AIRE,0,0,1,0,0,1
7,2022,LOMBARDIA,Residenti,1376,7890,8045,10241,31844,59396
7,2022,LUSSEMBURGO,AIRE,6,2,9,18,14,49
7,2022,MACEDONIA DEL NORD,AIRE,2,0,1,0,0,3
7,2022,MADAGASCAR,AIRE,3,0,0,0,0,3
7,2022,MALAYSIA,AIRE,0,2,2,2,2,8
7,2022,MALTA,AIRE,1,8,18,12,15,54
7,2022,MARCHE,Residenti,158,903,872,1115,2939,5987
7,2022,MAROCCO,AIRE,0,1,1,3,2,7
7,2022,MESSICO,AIRE,1,2,2,2,14,21
7,2022,MOLISE,Residenti,33,153,169,179,469,1003
7,2022,MONACO,AIRE,1,0,2,0,6,9
7,2022,MONTENEGRO,AIRE,0,0,0,0,1,1
7,2022,MYANMAR,AIRE,0,0,0,0,1,1
7,2022,NIGERIA,AIRE,0,0,1,0,0,1
7,2022,NORVEGIA,AIRE,3,4,4,1,2,14
7,2022,NUOVA CALEDONIA,AIRE,0,0,1,0,0,1
7,2022,PAESI BASSI,AIRE,7,8,17,20,22,74
7,2022,PANAMA,AIRE,0,0,1,0,0,1
7,2022,PERU',AIRE,0,1,0,0,3,4
7,2022,PIEMONTE,Residenti,531,2839,2811,4070,11454,21705
7,2022,POLONIA,AIRE,0,4,10,34,6,54
7,2022,PORTOGALLO,AIRE,10,7,12,20,27,76
7,2022,PUGLIA,Residenti,360,2118,1904,2946,7488,14816
7,2022,QATAR,AIRE,0,2,1,2,4,9
7,2022,REGNO UNITO,AIRE,48,64,101,177,173,563
7,2022,REPUBBLICA CECA,AIRE,10,9,3,17,17,56
7,2022,REPUBBLICA CENTRAFRICANA,AIRE,0,0,1,2,1,4
7,2022,REPUBBLICA DI COREA,AIRE,0,0,0,2,0,2
7,2022,REPUBBLICA POPOLARE CINESE,AIRE,1,15,5,10,8,39
7,2022,ROMANIA,AIRE,2,1,2,6,3,14
7,2022,SAN MARINO,AIRE,2,3,4,2,3,14
7,2022,SARDEGNA,Residenti,222,1280,1095,1526,3150,7273
7,2022,SERBIA,AIRE,2,0,1,1,3,7
7,2022,SICILIA,Residenti,1096,5795,2676,4949,9117,23633
7,2022,SINGAPORE,AIRE,0,5,0,0,1,6
7,2022,SLOVACCHIA,AIRE,0,1,0,4,1,6
7,2022,SLOVENIA,AIRE,0,4,2,7,0,13
7,2022,SPAGNA,AIRE,40,18,77,104,89,328
7,2022,STATI UNITI D'AMERICA,AIRE,24,14,26,35,58,157
7,2022,SUD AFRICA,AIRE,0,1,0,1,0,2
7,2022,SVEZIA,AIRE,3,3,1,9,8,24
7,2022,SVIZZERA,AIRE,13,23,69,99,125,329
7,2022,THAILANDIA,AIRE,2,2,6,8,5,23
7,2022,TOSCANA,Residenti,463,2827,2533,3518,9289,18630
7,2022,TRENTINO ALTO ADIGE,Residenti,90,426,713,787,1526,3542
7,2022,TUNISIA,AIRE,6,6,9,18,35,74
7,2022,TURCHIA,AIRE,0,2,0,3,2,7
7,2022,UMBRIA,Residenti,113,933,571,791,2023,4431
7,2022,UNGHERIA,AIRE,1,1,2,1,1,6
7,2022,URUGUAY,AIRE,1,1,0,0,0,2
7,2022,VALLE D'AOSTA,Residenti,6,54,60,61,234,415
7,2022,VENETO,Residenti,493,3818,4085,4657,13576,26629
7,2022,VENEZUELA,AIRE,1,7,6,6,0,20
7,2022,VIETNAM,AIRE,0,1,0,1,4,6
8,2022,ABRUZZO,Residenti,123,833,560,940,2016,4472
8,2022,ALBANIA,AIRE,0,7,1,1,3,12
8,2022,ALGERIA,AIRE,0,0,1,0,1,2
8,2022,ANGOLA,AIRE,0,0,0,1,0,1
8,2022,ARABIA SAUDITA,AIRE,0,1,1,3,2,7
8,2022,ARGENTINA,AIRE,11,7,18,14,15,65
8,2022,AUSTRALIA,AIRE,1,2,7,10,14,34
8,2022,AUSTRIA,AIRE,2,1,12,14,20,49
8,2022,BAHREIN,AIRE,1,0,0,0,0,1
8,2022,BASILICATA,Residenti,60,279,225,346,756,1666
8,2022,BELGIO,AIRE,9,4,14,47,33,107
8,2022,BELIZE,AIRE,0,0,0,1,0,1
8,2022,BIELORUSSIA,AIRE,0,0,0,0,2,2
8,2022,BOSNIA-ERZEGOVINA,AIRE,0,0,0,1,0,1
8,2022,BRASILE,AIRE,18,9,64,64,49,204
8,2022,BULGARIA,AIRE,0,0,2,6,8,16
8,2022,BURKINA FASO,AIRE,0,0,1,1,2,4
8,2022,CALABRIA,Residenti,271,1025,873,1440,2639,6248
8,2022,CAMBOGIA,AIRE,0,0,1,0,2,3
8,2022,CAMPANIA,Residenti,682,2439,2546,4138,9232,19037
8,2022,CANADA,AIRE,2,2,4,4,5,17
8,2022,CAPO VERDE,AIRE,0,0,0,0,1,1
8,2022,CILE,AIRE,2,1,1,1,4,9
8,2022,CIPRO,AIRE,0,0,2,3,2,7
8,2022,COLOMBIA,AIRE,0,5,0,3,3,11
8,2022,CONGO,AIRE,0,1,0,0,2,3
8,2022,COSTA RICA,AIRE,0,0,0,0,2,2
8,2022,CROAZIA,AIRE,1,1,3,0,0,5
8,2022,CUBA,AIRE,0,0,1,0,1,2
8,2022,DANIMARCA,AIRE,3,0,2,2,1,8
8,2022,ECUADOR,AIRE,0,0,1,0,0,1
8,2022,EGITTO,AIRE,1,1,2,1,1,6
8,2022,EMILIA ROMAGNA,Residenti,501,3057,3297,4281,12000,23136
8,2022,EMIRATI ARABI UNITI,AIRE,3,4,16,17,40,80
8,2022,ETIOPIA,AIRE,0,1,1,1,0,3
8,2022,FEDERAZIONE RUSSA,AIRE,1,1,3,8,10,23
8,2022,FINLANDIA,AIRE,2,2,2,7,2,15
8,2022,FRANCIA,AIRE,28,38,65,101,124,356
8,2022,FRIULI VENEZIA GIULIA,Residenti,96,751,922,1186,3004,5959
8,2022,GEORGIA,AIRE,0,0,1,1,1,3
8,2022,GERMANIA,AIRE,23,27,68,122,109,349
8,2022,GIAPPONE,AIRE,0,0,4,7,5,16
8,2022,GIBILTERRA,AIRE,0,0,1,0,0,1
8,2022,GIORDANIA,AIRE,0,0,1,1,0,2
8,2022,GRECIA,AIRE,5,4,1,0,6,16
8,2022,IGNOTO,AIRE,0,0,0,2,1,3
8,2022,INDIA,AIRE,2,0,0,2,1,5
8,2022,INDONESIA,AIRE,0,1,1,0,1,3
8,2022,IRLANDA,AIRE,6,6,14,20,10,56
8,2022,ISLANDA,AIRE,0,0,0,0,3,3
8,2022,KAZAKHSTAN,AIRE,3,1,0,0,0,4
8,2022,KENYA,AIRE,0,3,1,1,1,6
8,2022,LAZIO,Residenti,943,3180,2859,5079,10053,22114
8,2022,LETTONIA,AIRE,0,0,2,2,5,9
8,2022,LIBANO,AIRE,0,1,0,0,0,1
8,2022,LIGURIA,Residenti,143,811,824,1209,3142,6129
8,2022,LOMBARDIA,Residenti,945,6564,5756,7661,20937,41863
8,2022,LUSSEMBURGO,AIRE,2,5,11,23,20,61
8,2022,MACEDONIA DEL NORD,AIRE,0,0,2,0,0,2
8,2022,MADAGASCAR,AIRE,0,0,0,0,1,1
8,2022,MALAYSIA,AIRE,0,1,0,0,0,1
8,2022,MALTA,AIRE,4,4,12,9,4,33
8,2022,MARCHE,Residenti,111,784,861,1127,2916,5799
8,2022,MAROCCO,AIRE,1,0,1,3,3,8
8,2022,MAURITIUS,AIRE,0,0,1,5,0,6
8,2022,MESSICO,AIRE,0,0,4,3,8,15
8,2022,MOLDOVA,AIRE,0,0,0,0,2,2
8,2022,MOLISE,Residenti,22,175,135,166,374,872
8,2022,MONACO,AIRE,0,0,3,2,0,5
8,2022,NORVEGIA,AIRE,0,0,1,1,2,4
8,2022,NUOVA ZELANDA,AIRE,2,0,1,0,12,15
8,2022,OMAN,AIRE,0,0,1,0,0,1
8,2022,PAESI BASSI,AIRE,5,13,19,33,32,102
8,2022,PANAMA,AIRE,1,0,2,0,0,3
8,2022,PERU',AIRE,2,1,1,1,1,6
8,2022,PIEMONTE,Residenti,450,2565,2155,3394,7834,16398
8,2022,POLONIA,AIRE,4,6,14,31,14,69
8,2022,PORTOGALLO,AIRE,7,0,16,69,32,124
8,2022,PUGLIA,Residenti,355,1848,1618,2475,6210,12506
8,2022,QATAR,AIRE,0,4,2,4,14,24
8,2022,REGNO UNITO,AIRE,65,87,112,225,195,684
8,2022,REPUBBLICA CECA,AIRE,7,14,2,17,12,52
8,2022,REPUBBLICA DEMOCRATICA DEL CONGO,AIRE,0,1,0,0,0,1
8,2022,REPUBBLICA DI COREA,AIRE,2,0,1,3,2,8
8,2022,REPUBBLICA DOMINICANA,AIRE,0,3,3,6,2,14
8,2022,REPUBBLICA POPOLARE CINESE,AIRE,4,5,10,5,9,33
8,2022,ROMANIA,AIRE,0,4,2,5,4,15
8,2022,SAN MARINO,AIRE,2,0,2,1,2,7
8,2022,SARDEGNA,Residenti,171,1231,775,1256,2605,6038
8,2022,SICILIA,Residenti,1061,5318,2454,4883,7713,21429
8,2022,SINGAPORE,AIRE,0,1,2,5,3,11
8,2022,SLOVACCHIA,AIRE,0,0,0,0,4,4
8,2022,SLOVENIA,AIRE,0,1,0,3,2,6
8,2022,SPAGNA,AIRE,37,30,82,72,126,347
8,2022,STATI UNITI D'AMERICA,AIRE,15,26,31,56,92,220
8,2022,SVEZIA,AIRE,3,1,3,7,4,18
8,2022,SVIZZERA,AIRE,32,26,66,84,116,324
8,2022,TAIWAN,AIRE,0,2,1,0,2,5
8,2022,THAILANDIA,AIRE,2,0,4,3,12,21
8,2022,TOSCANA,Residenti,401,2536,2016,2795,7261,15009
8,2022,TRENTINO ALTO ADIGE,Residenti,80,409,629,675,1494,3287
8,2022,TUNISIA,AIRE,2,3,10,5,14,34
8,2022,TURCHIA,AIRE,0,1,2,4,5,12
8,2022,UCRAINA,AIRE,1,0,0,0,2,3
8,2022,UMBRIA,Residenti,135,900,526,853,2008,4422
8,2022,UNGHERIA,AIRE,1,1,7,6,10,25
8,2022,URUGUAY,AIRE,0,0,1,0,0,1
8,2022,VALLE D'AOSTA,Residenti,7,43,96,81,250,477
8,2022,VENETO,Residenti,452,3491,3540,4127,11603,23213
8,2022,VENEZUELA,AIRE,2,3,4,7,2,18
8,2022,VIETNAM,AIRE,0,0,1,1,0,2
9,2022,ABRUZZO,Residenti,206,1123,918,1303,3859,7409
9,2022,ALBANIA,AIRE,1,1,3,1,17,23
9,2022,ANGOLA,AIRE,0,0,1,1,1,3
9,2022,ANTIGUA E BARBUDA,AIRE,0,1,0,0,0,1
9,2022,ARABIA SAUDITA,AIRE,5,2,3,2,2,14
9,2022,ARGENTINA,AIRE,6,4,24,30,20,84
9,2022,AUSTRALIA,AIRE,5,8,8,12,11,44
9,2022,AUSTRIA,AIRE,0,9,16,7,15,47
9,2022,BAHREIN,AIRE,1,0,0,3,3,7
9,2022,BASILICATA,Residenti,72,384,378,512,1271,2617
9,2022,BELGIO,AIRE,8,13,12,29,15,77
9,2022,BENIN,AIRE,1,0,0,0,0,1
9,2022,BRASILE,AIRE,12,8,47,82,55,204
9,2022,BULGARIA,AIRE,1,3,4,3,11,22
9,2022,CALABRIA,Residenti,331,1337,1487,2127,5329,10611
9,2022,CAMERUN,AIRE,0,0,0,0,2,2
9,2022,CAMPANIA,Residenti,991,3947,4223,7119,20870,37150
9,2022,CANADA,AIRE,0,0,3,15,9,27
9,2022,CAPO VERDE,AIRE,0,0,0,1,1,2
9,2022,CILE,AIRE,1,0,1,2,1,5
9,2022,CIPRO,AIRE,2,3,4,6,7,22
9,2022,COLOMBIA,AIRE,0,2,1,2,4,9
9,2022,CONGO,AIRE,1,0,0,0,1,2
9,2022,COSTA RICA,AIRE,0,1,0,0,2,3
9,2022,CROAZIA,AIRE,0,0,2,0,5,7
9,2022,CUBA,AIRE,0,2,0,0,4,6
9,2022,DANIMARCA,AIRE,6,6,3,12,1,28
9,2022,EGITTO,AIRE,1,1,1,4,8,15
9,2022,EMILIA ROMAGNA,Residenti,619,4139,5027,6268,19422,35475
9,2022,EMIRATI ARABI UNITI,AIRE,7,11,6,7,14,45
9,2022,ESTONIA,AIRE,0,0,0,1,0,1
9,2022,FEDERAZIONE RUSSA,AIRE,2,4,3,8,14,31
9,2022,FILIPPINE,AIRE,0,1,1,0,1,3
9,2022,FINLANDIA,AIRE,0,1,4,8,8,21
9,2022,FRANCIA,AIRE,36,38,76,87,123,360
9,2022,FRIULI VENEZIA GIULIA,Residenti,135,847,1135,1483,4277,7877
9,2022,GERMANIA,AIRE,38,53,55,102,113,361
9,2022,GERUSALEMME,AIRE,0,1,0,0,0,1
9,2022,GIAMAICA,AIRE,0,0,0,0,2,2
9,2022,GIAPPONE,AIRE,1,0,1,4,2,8
9,2022,GRECIA,AIRE,3,0,6,7,26,42
9,2022,GUADALUPA,AIRE,0,0,0,0,3,3
9,2022,GUATEMALA,AIRE,0,0,0,0,2,2
9,2022,IGNOTO,AIRE,0,1,0,0,2,3
9,2022,INDIA,AIRE,0,0,3,0,2,5
9,2022,IRLANDA,AIRE,3,17,5,15,6,46
9,2022,ISLANDA,AIRE,0,0,1,1,0,2
9,2022,ISRAELE,AIRE,0,0,0,1,0,1
9,2022,KAZAKHSTAN,AIRE,0,2,0,1,1,4
9,2022,KENYA,AIRE,1,0,1,1,3,6
9,2022,KOSOVO,AIRE,0,0,0,1,1,2
9,2022,KUWAIT,AIRE,0,1,0,0,0,1
9,2022,LAZIO,Residenti,1386,4543,4443,7555,19736,37663
9,2022,LETTONIA,AIRE,0,0,1,0,1,2
9,2022,LIBANO,AIRE,0,0,0,0,2,2
9,2022,LIGURIA,Residenti,179,1142,1150,1433,4920,8824
9,2022,LOMBARDIA,Residenti,1467,8551,9859,11988,39085,70950
9,2022,LUSSEMBURGO,AIRE,1,2,11,14,21,49
9,2022,MADAGASCAR,AIRE,0,1,1,0,3,5
9,2022,MALAYSIA,AIRE,0,0,0,0,1,1
9,2022,MALDIVE,AIRE,0,0,0,2,0,2
9,2022,MALTA,AIRE,10,11,8,10,10,49
9,2022,MARCHE,Residenti,133,879,1143,1497,4738,8390
9,2022,MAROCCO,AIRE,0,0,1,0,3,4
9,2022,MESSICO,AIRE,5,2,5,5,19,36
9,2022,MOLISE,Residenti,49,211,194,271,707,1432
9,2022,MONACO,AIRE,1,0,2,2,10,15
9,2022,MOZAMBICO,AIRE,0,2,0,0,0,2
9,2022,NORVEGIA,AIRE,2,7,7,1,4,21
9,2022,PAESI BASSI,AIRE,10,10,12,71,18,121
9,2022,PANAMA,AIRE,1,2,1,1,1,6
9,2022,PERU',AIRE,0,9,0,3,3,15
9,2022,PIEMONTE,Residenti,596,3428,3556,4668,14746,26994
9,2022,POLONIA,AIRE,3,8,3,8,6,28
9,2022,PORTOGALLO,AIRE,6,7,24,19,28,84
9,2022,PUGLIA,Residenti,569,2592,2352,3614,11892,21019
9,2022,QATAR,AIRE,3,4,2,3,6,18
9,2022,REGNO UNITO,AIRE,53,95,124,179,157,608
9,2022,REPUBBLICA CECA,AIRE,7,3,5,5,11,31
9,2022,REPUBBLICA CENTRAFRICANA,AIRE,0,0,0,2,1,3
9,2022,REPUBBLICA DI COREA,AIRE,0,0,0,0,1,1
9,2022,REPUBBLICA DOMINICANA,AIRE,0,4,1,6,3,14
9,2022,REPUBBLICA POPOLARE CINESE,AIRE,6,3,9,18,14,50
9,2022,ROMANIA,AIRE,3,3,4,7,20,37
9,2022,SAN MARINO,AIRE,5,1,3,1,2,12
9,2022,SARDEGNA,Residenti,241,1501,1339,2067,5806,10954
9,2022,SENEGAL,AIRE,0,1,0,1,1,3
9,2022,SERBIA,AIRE,0,0,0,0,1,1
9,2022,SICILIA,Residenti,1329,7410,3551,6210,12445,30945
9,2022,SINGAPORE,AIRE,0,1,0,1,0,2
9,2022,SIRIA,AIRE,1,0,0,0,1,2
9,2022,SLOVACCHIA,AIRE,0,0,1,0,6,7
9,2022,SLOVENIA,AIRE,0,3,0,0,2,5
9,2022,SPAGNA,AIRE,36,29,78,113,79,335
9,2022,STATI UNITI D'AMERICA,AIRE,19,28,32,53,56,188
9,2022,SUD AFRICA,AIRE,0,0,1,0,1,2
9,2022,SVEZIA,AIRE,1,7,2,2,0,12
9,2022,SVIZZERA,AIRE,32,21,68,79,94,294
9,2022,TAIWAN,AIRE,1,3,1,0,0,5
9,2022,TANZANIA,AIRE,0,0,1,0,0,1
9,2022,THAILANDIA,AIRE,0,0,8,7,10,25
9,2022,TOSCANA,Residenti,524,3451,3214,3943,11721,22853
9,2022,TRENTINO ALTO ADIGE,Residenti,107,479,751,1007,1956,4300
9,2022,TUNISIA,AIRE,3,2,31,3,17,56
9,2022,TURCHIA,AIRE,2,3,0,2,1,8
9,2022,UCRAINA,AIRE,0,0,1,1,0,2
9,2022,UMBRIA,Residenti,124,1067,769,1044,3198,6202
9,2022,UNGHERIA,AIRE,1,0,2,0,0,3
9,2022,URUGUAY,AIRE,0,0,0,1,2,3
9,2022,UZBEKISTAN,AIRE,2,0,3,0,0,5
9,2022,VALLE D'AOSTA,Residenti,8,66,97,125,329,625
9,2022,VENETO,Residenti,554,4300,4797,5614,18384,33649
9,2022,VENEZUELA,AIRE,2,3,9,5,1,20
9,2022,VIETNAM,AIRE,0,1,0,0,0,1
10,2022,ABRUZZO,Residenti,42,249,98,176,712,1277
10,2022,ALBANIA,AIRE,0,1,1,2,0,4
10,2022,ARABIA SAUDITA,AIRE,0,0,0,0,3,3
10,2022,ARGENTINA,AIRE,0,1,5,12,7,25
10,2022,AUSTRALIA,AIRE,2,0,0,0,1,3
10,2022,AUSTRIA,AIRE,0,1,0,4,6,11
10,2022,BASILICATA,Residenti,8,91,44,41,236,420
10,2022,BELGIO,AIRE,1,3,3,1,4,12
10,2022,BRASILE,AIRE,1,3,1,8,0,13
10,2022,BULGARIA,AIRE,0,0,1,1,1,3
10,2022,CALABRIA,Residenti,72,258,164,225,1070,1789
10,2022,CAMPANIA,Residenti,178,949,469,749,3857,6202
10,2022,CANADA,AIRE,0,0,0,2,4,6
10,2022,COLOMBIA,AIRE,0,1,0,0,0,1
10,2022,COSTA D'AVORIO,AIRE,2,0,0,3,0,5
10,2022,COSTA RICA,AIRE,2,0,0,0,0,2
10,2022,CUBA,AIRE,0,0,0,0,1,1
10,2022,DANIMARCA,AIRE,0,1,0,0,0,1
10,2022,EMILIA ROMAGNA,Residenti,123,970,549,677,3410,5729
10,2022,EMIRATI ARABI UNITI,AIRE,0,0,3,0,4,7
10,2022,ETIOPIA,AIRE,0,0,1,0,0,1
10,2022,FEDERAZIONE RUSSA,AIRE,0,2,0,0,1,3
10,2022,FRANCIA,AIRE,8,11,11,15,39,84
10,2022,FRIULI VENEZIA GIULIA,Residenti,20,166,117,158,727,1188
10,2022,GERMANIA,AIRE,4,14,1,13,9,41
10,2022,GRECIA,AIRE,0,2,0,0,0,2
10,2022,GUADALUPA,AIRE,0,0,0,2,1,3
10,2022,IRLANDA,AIRE,2,1,2,3,2,10
10,2022,ISRAELE,AIRE,0,0,0,0,2,2
10,2022,LAZIO,Residenti,264,971,483,810,3625,6153
10,2022,LETTONIA,AIRE,0,1,0,0,0,1
10,2022,LIGURIA,Residenti,31,254,112,166,877,1440
10,2022,LOMBARDIA,Residenti,309,2085,1130,1289,7370,12183
10,2022,LUSSEMBURGO,AIRE,1,1,1,0,2,5
10,2022,MALAYSIA,AIRE,0,1,0,0,0,1
10,2022,MALDIVE,AIRE,1,0,4,1,0,6
10,2022,MALTA,AIRE,1,2,0,2,1,6
10,2022,MARCHE,Residenti,47,217,110,163,817,1354
10,2022,MAROCCO,AIRE,0,4,0,0,0,4
10,2022,MESSICO,AIRE,0,0,2,0,0,2
10,2022,MOLDOVA,AIRE,0,0,1,0,0,1
10,2022,MOLISE,Residenti,5,61,39,30,164,299
10,2022,NORVEGIA,AIRE,0,3,0,0,0,3
10,2022,PAESI BASSI,AIRE,0,0,1,0,4,5
10,2022,PANAMA,AIRE,0,1,0,0,3,4
10,2022,PERU',AIRE,0,0,0,1,0,1
10,2022,PIEMONTE,Residenti,141,765,350,508,2585,4349
10,2022,POLONIA,AIRE,0,2,0,1,1,4
10,2022,PORTOGALLO,AIRE,1,2,2,16,9,30
10,2022,PUGLIA,Residenti,133,592,291,408,2172,3596
10,2022,QATAR,AIRE,0,0,0,0,1,1
10,2022,REGNO UNITO,AIRE,7,38,18,30,55,148
10,2022,REPUBBLICA CECA,AIRE,2,6,1,5,3,17
10,2022,REPUBBLICA DOMINICANA,AIRE,1,0,3,2,1,7
10,2022,REPUBBLICA POPOLARE CINESE,AIRE,0,1,0,2,0,3
10,2022,ROMANIA,AIRE,0,0,1,0,2,3
10,2022,RUANDA,AIRE,0,1,0,0,0,1
10,2022,SARDEGNA,Residenti,61,346,130,254,1064,1855
10,2022,SICILIA,Residenti,211,1568,389,629,2333,5130
10,2022,SINGAPORE,AIRE,0,1,0,0,1,2
10,2022,SPAGNA,AIRE,6,3,8,6,21,44
10,2022,STATI UNITI D'AMERICA,AIRE,6,7,3,3,8,27
10,2022,SUD AFRICA,AIRE,0,0,0,0,3,3
10,2022,SVEZIA,AIRE,1,2,1,0,0,4
10,2022,SVIZZERA,AIRE,3,5,11,13,12,44
10,2022,TAIWAN,AIRE,0,1,0,0,0,1
10,2022,THAILANDIA,AIRE,0,0,1,0,1,2
10,2022,TOSCANA,Residenti,127,792,375,417,2108,3819
10,2022,TRENTINO ALTO ADIGE,Residenti,12,89,94,114,397,706
10,2022,TUNISIA,AIRE,2,0,4,1,3,10
10,2022,TURCHIA,AIRE,0,0,3,0,2,5
10,2022,UCRAINA,AIRE,0,1,3,0,2,6
10,2022,UMBRIA,Residenti,39,290,91,112,655,1187
10,2022,UNGHERIA,AIRE,1,0,0,2,0,3
10,2022,VALLE D'AOSTA,Residenti,3,17,11,7,111,149
10,2022,VENETO,Residenti,101,1037,530,629,3445,5742
10,2022,VENEZUELA,AIRE,0,0,1,0,0,1